Date,Description,Amount,Transaction Type,Category,Account Name,Type,Month,Year,MonthYear,AbsAmount,CumulativeBalance,Budget,BudgetUsedPct
2018-01-01,Amazon,11.11,debit,Shopping,Platinum Card,Expense,1,2018,2018-01,11.11,11.11,100.0,11.11
2018-01-02,Mortgage Payment,1247.44,debit,Mortgage & Rent,Checking,Expense,1,2018,2018-01,1247.44,1258.55,1100.0,113.40363636363637
2018-01-02,Thai Restaurant,24.22,debit,Restaurants,Silver Card,Expense,1,2018,2018-01,24.22,1282.77,150.0,16.146666666666665
2018-01-03,Credit Card Payment,2298.09,credit,Credit Card Payment,Platinum Card,Income,1,2018,2018-01,2298.09,3580.86,,
2018-01-04,Netflix,11.76,debit,Movies & DVDs,Platinum Card,Expense,1,2018,2018-01,11.76,3592.6200000000003,0.0,
2018-01-05,American Tavern,25.85,debit,Restaurants,Silver Card,Expense,1,2018,2018-01,25.85,3618.4700000000003,150.0,17.233333333333334
2018-01-06,Hardware Store,18.45,debit,Home Improvement,Silver Card,Expense,1,2018,2018-01,18.45,3636.92,250.0,7.379999999999999
2018-01-08,Gas Company,45.0,debit,Utilities,Checking,Expense,1,2018,2018-01,45.0,3681.92,150.0,30.0
2018-01-08,Hardware Store,15.38,debit,Home Improvement,Silver Card,Expense,1,2018,2018-01,15.38,3697.3,250.0,6.152
2018-01-09,Spotify,10.69,debit,Music,Platinum Card,Expense,1,2018,2018-01,10.69,3707.9900000000002,11.0,97.18181818181819
2018-01-10,Phone Company,89.46,debit,Mobile Phone,Checking,Expense,1,2018,2018-01,89.46,3797.4500000000003,65.0,137.63076923076923
2018-01-11,Grocery Store,43.54,debit,Groceries,Platinum Card,Expense,1,2018,2018-01,43.54,3840.9900000000002,150.0,29.026666666666667
2018-01-11,Shell,34.87,debit,Gas & Fuel,Platinum Card,Expense,1,2018,2018-01,34.87,3875.86,75.0,46.49333333333333
2018-01-12,Biweekly Paycheck,2000.0,credit,Paycheck,Checking,Income,1,2018,2018-01,2000.0,5875.860000000001,,
2018-01-13,Pizza Place,32.91,debit,Fast Food,Platinum Card,Expense,1,2018,2018-01,32.91,5908.77,15.0,219.4
2018-01-13,Amazon,39.05,debit,Shopping,Platinum Card,Expense,1,2018,2018-01,39.05,5947.820000000001,100.0,39.05
2018-01-15,Grocery Store,44.19,debit,Groceries,Silver Card,Expense,1,2018,2018-01,44.19,5992.01,150.0,29.459999999999997
2018-01-15,American Tavern,64.11,debit,Restaurants,Silver Card,Expense,1,2018,2018-01,64.11,6056.12,150.0,42.74
2018-01-16,City Water Charges,35.0,debit,Utilities,Checking,Expense,1,2018,2018-01,35.0,6091.12,150.0,23.333333333333332
2018-01-16,Power Company,60.0,debit,Utilities,Checking,Expense,1,2018,2018-01,60.0,6151.12,150.0,40.0
2018-01-19,Biweekly Paycheck,2000.0,credit,Paycheck,Checking,Income,1,2018,2018-01,2000.0,8151.12,,
2018-01-20,Amazon,50.21,debit,Shopping,Platinum Card,Expense,1,2018,2018-01,50.21,8201.33,100.0,50.21
2018-01-22,Hardware Store,17.38,debit,Home Improvement,Silver Card,Expense,1,2018,2018-01,17.38,8218.71,250.0,6.952
2018-01-22,Credit Card Payment,309.81,credit,Credit Card Payment,Silver Card,Income,1,2018,2018-01,309.81,8528.519999999999,,
2018-01-22,Credit Card Payment,554.99,credit,Credit Card Payment,Platinum Card,Income,1,2018,2018-01,554.99,9083.509999999998,,
2018-01-23,Credit Card Payment,309.81,debit,Credit Card Payment,Checking,Expense,1,2018,2018-01,309.81,9393.319999999998,,
2018-01-24,Starbucks,3.0,debit,Coffee Shops,Platinum Card,Expense,1,2018,2018-01,3.0,9396.319999999998,15.0,20.0
2018-01-25,Internet Service Provider,69.99,debit,Internet,Checking,Expense,1,2018,2018-01,69.99,9466.309999999998,75.0,93.32
2018-01-29,Shell,30.42,debit,Gas & Fuel,Silver Card,Expense,1,2018,2018-01,30.42,9496.729999999998,75.0,40.56
2018-01-29,Thai Restaurant,25.0,debit,Restaurants,Silver Card,Expense,1,2018,2018-01,25.0,9521.729999999998,150.0,16.666666666666664
2018-01-29,Brunch Restaurant,17.62,debit,Restaurants,Platinum Card,Expense,1,2018,2018-01,17.62,9539.349999999999,150.0,11.746666666666668
2018-02-01,Grocery Store,27.79,debit,Groceries,Platinum Card,Expense,2,2018,2018-02,27.79,9567.14,150.0,18.526666666666667
2018-02-01,Amazon,11.11,debit,Shopping,Platinum Card,Expense,2,2018,2018-02,11.11,9578.25,100.0,11.11
2018-02-02,Mortgage Payment,1247.44,debit,Mortgage & Rent,Checking,Expense,2,2018,2018-02,1247.44,10825.69,1100.0,113.40363636363637
2018-02-02,Biweekly Paycheck,2000.0,credit,Paycheck,Checking,Income,2,2018,2018-02,2000.0,12825.69,,
2018-02-03,Japanese Restaurant,57.02,debit,Restaurants,Platinum Card,Expense,2,2018,2018-02,57.02,12882.710000000001,150.0,38.013333333333335
2018-02-04,Netflix,11.76,debit,Movies & DVDs,Platinum Card,Expense,2,2018,2018-02,11.76,12894.470000000001,0.0,
2018-02-05,Credit Card Payment,145.14,credit,Credit Card Payment,Platinum Card,Income,2,2018,2018-02,145.14,13039.61,,
2018-02-06,Credit Card Payment,154.13,credit,Credit Card Payment,Silver Card,Income,2,2018,2018-02,154.13,13193.74,,
2018-02-07,Credit Card Payment,154.13,debit,Credit Card Payment,Checking,Expense,2,2018,2018-02,154.13,13347.869999999999,,
2018-02-07,Gas Company,65.0,debit,Utilities,Checking,Expense,2,2018,2018-02,65.0,13412.869999999999,150.0,43.333333333333336
2018-02-09,Barbershop,30.0,debit,Haircut,Platinum Card,Expense,2,2018,2018-02,30.0,13442.869999999999,30.0,100.0
2018-02-09,Spotify,10.69,debit,Music,Platinum Card,Expense,2,2018,2018-02,10.69,13453.56,11.0,97.18181818181819
2018-02-10,Bojangles,10.66,debit,Fast Food,Platinum Card,Expense,2,2018,2018-02,10.66,13464.22,15.0,71.06666666666666
2018-02-11,Fancy Restaurant,106.8,debit,Restaurants,Platinum Card,Expense,2,2018,2018-02,106.8,13571.019999999999,150.0,71.2
2018-02-12,Shell,36.47,debit,Gas & Fuel,Silver Card,Expense,2,2018,2018-02,36.47,13607.489999999998,75.0,48.626666666666665
2018-02-12,Phone Company,89.52,debit,Mobile Phone,Checking,Expense,2,2018,2018-02,89.52,13697.009999999998,65.0,137.72307692307692
2018-02-14,Brewing Company,14.0,debit,Alcohol & Bars,Silver Card,Expense,2,2018,2018-02,14.0,13711.009999999998,50.0,28.000000000000004
2018-02-15,American Tavern,10.0,debit,Restaurants,Platinum Card,Expense,2,2018,2018-02,10.0,13721.009999999998,150.0,6.666666666666667
2018-02-15,Power Company,60.0,debit,Utilities,Checking,Expense,2,2018,2018-02,60.0,13781.009999999998,150.0,40.0
2018-02-16,Biweekly Paycheck,2000.0,credit,Paycheck,Checking,Income,2,2018,2018-02,2000.0,15781.009999999998,,
2018-02-16,Brunch Restaurant,8.0,debit,Restaurants,Silver Card,Expense,2,2018,2018-02,8.0,15789.009999999998,150.0,5.333333333333334
2018-02-16,City Water Charges,35.0,debit,Utilities,Checking,Expense,2,2018,2018-02,35.0,15824.009999999998,150.0,23.333333333333332
2018-02-20,Grocery Store,35.95,debit,Groceries,Silver Card,Expense,2,2018,2018-02,35.95,15859.96,150.0,23.96666666666667
2018-02-20,Mexican Restaurant,23.51,debit,Restaurants,Silver Card,Expense,2,2018,2018-02,23.51,15883.47,150.0,15.673333333333334
2018-02-21,Starbucks,2.0,debit,Coffee Shops,Platinum Card,Expense,2,2018,2018-02,2.0,15885.47,15.0,13.333333333333334
2018-02-22,Starbucks,4.0,debit,Coffee Shops,Silver Card,Expense,2,2018,2018-02,4.0,15889.47,15.0,26.666666666666668
2018-02-26,Gas Station,32.21,debit,Gas & Fuel,Silver Card,Expense,2,2018,2018-02,32.21,15921.679999999998,75.0,42.946666666666665
2018-02-26,American Tavern,85.52,debit,Restaurants,Silver Card,Expense,2,2018,2018-02,85.52,16007.199999999999,150.0,57.01333333333333
2018-02-26,Internet Service Provider,74.99,debit,Internet,Checking,Expense,2,2018,2018-02,74.99,16082.189999999999,75.0,99.98666666666665
2018-02-26,Credit Card Payment,156.11,credit,Credit Card Payment,Silver Card,Income,2,2018,2018-02,156.11,16238.3,,
2018-02-26,Credit Card Payment,765.37,credit,Credit Card Payment,Platinum Card,Income,2,2018,2018-02,765.37,17003.67,,
2018-02-27,Credit Card Payment,156.11,debit,Credit Card Payment,Checking,Expense,2,2018,2018-02,156.11,17159.78,,
2018-03-01,Grocery Store,32.07,debit,Groceries,Silver Card,Expense,3,2018,2018-03,32.07,17191.85,150.0,21.38
2018-03-01,Amazon,13.13,debit,Shopping,Platinum Card,Expense,3,2018,2018-03,13.13,17204.98,100.0,13.13
2018-03-02,Mortgage Payment,1247.44,debit,Mortgage & Rent,Checking,Expense,3,2018,2018-03,1247.44,18452.42,1100.0,113.40363636363637
2018-03-02,Biweekly Paycheck,2000.0,credit,Paycheck,Checking,Income,3,2018,2018-03,2000.0,20452.42,,
2018-03-03,Grocery Store,23.74,debit,Groceries,Silver Card,Expense,3,2018,2018-03,23.74,20476.16,150.0,15.826666666666666
2018-03-04,Grocery Store,10.69,debit,Groceries,Platinum Card,Expense,3,2018,2018-03,10.69,20486.85,150.0,7.126666666666666
2018-03-04,Netflix,11.76,debit,Movies & DVDs,Platinum Card,Expense,3,2018,2018-03,11.76,20498.609999999997,0.0,
2018-03-04,BBQ Restaurant,42.24,debit,Restaurants,Platinum Card,Expense,3,2018,2018-03,42.24,20540.85,150.0,28.16
2018-03-05,Credit Card Payment,761.59,credit,Credit Card Payment,Silver Card,Income,3,2018,2018-03,761.59,21302.44,,
2018-03-05,Starbucks,3.0,debit,Coffee Shops,Platinum Card,Expense,3,2018,2018-03,3.0,21305.44,15.0,20.0
2018-03-07,Starbucks,3.5,debit,Coffee Shops,Platinum Card,Expense,3,2018,2018-03,3.5,21308.94,15.0,23.333333333333332
2018-03-08,BP,34.9,debit,Gas & Fuel,Platinum Card,Expense,3,2018,2018-03,34.9,21343.84,75.0,46.53333333333333
2018-03-08,Gas Company,52.0,debit,Utilities,Checking,Expense,3,2018,2018-03,52.0,21395.84,150.0,34.66666666666667
2018-03-09,Grocery Store,20.72,debit,Groceries,Platinum Card,Expense,3,2018,2018-03,20.72,21416.56,150.0,13.813333333333333
2018-03-09,Grocery Store,5.09,debit,Groceries,Platinum Card,Expense,3,2018,2018-03,5.09,21421.65,150.0,3.393333333333333
2018-03-09,Spotify,10.69,debit,Music,Platinum Card,Expense,3,2018,2018-03,10.69,21432.34,11.0,97.18181818181819
2018-03-12,Grocery Store,19.35,debit,Groceries,Platinum Card,Expense,3,2018,2018-03,19.35,21451.69,150.0,12.9
2018-03-12,Phone Company,89.52,debit,Mobile Phone,Checking,Expense,3,2018,2018-03,89.52,21541.21,65.0,137.72307692307692
2018-03-13,Amazon,45.75,debit,Shopping,Platinum Card,Expense,3,2018,2018-03,45.75,21586.96,100.0,45.75
2018-03-14,Grocery Store,22.5,debit,Groceries,Platinum Card,Expense,3,2018,2018-03,22.5,21609.46,150.0,15.0
2018-03-14,Brunch Restaurant,8.49,debit,Restaurants,Platinum Card,Expense,3,2018,2018-03,8.49,21617.95,150.0,5.66
2018-03-15,Power Company,60.0,debit,Utilities,Checking,Expense,3,2018,2018-03,60.0,21677.95,150.0,40.0
2018-03-15,Starbucks,3.5,debit,Coffee Shops,Platinum Card,Expense,3,2018,2018-03,3.5,21681.45,15.0,23.333333333333332
2018-03-16,Biweekly Paycheck,2000.0,credit,Paycheck,Checking,Income,3,2018,2018-03,2000.0,23681.45,,
2018-03-17,Brewing Company,19.5,debit,Alcohol & Bars,Silver Card,Expense,3,2018,2018-03,19.5,23700.95,50.0,39.0
2018-03-17,Pizza Place,23.34,debit,Fast Food,Platinum Card,Expense,3,2018,2018-03,23.34,23724.29,15.0,155.6
2018-03-19,Mediterranean Restaurant,36.48,debit,Restaurants,Silver Card,Expense,3,2018,2018-03,36.48,23760.77,150.0,24.319999999999997
2018-03-19,City Water Charges,35.0,debit,Utilities,Checking,Expense,3,2018,2018-03,35.0,23795.77,150.0,23.333333333333332
2018-03-20,Amazon,14.97,debit,Shopping,Platinum Card,Expense,3,2018,2018-03,14.97,23810.74,100.0,14.97
2018-03-22,BP,30.55,debit,Gas & Fuel,Silver Card,Expense,3,2018,2018-03,30.55,23841.29,75.0,40.733333333333334
2018-03-23,Credit Card Payment,559.91,credit,Credit Card Payment,Platinum Card,Income,3,2018,2018-03,559.91,24401.2,,
2018-03-23,Grocery Store,11.76,debit,Groceries,Silver Card,Expense,3,2018,2018-03,11.76,24412.96,150.0,7.84
2018-03-26,Internet Service Provider,74.99,debit,Internet,Checking,Expense,3,2018,2018-03,74.99,24487.95,75.0,99.98666666666665
2018-03-28,Pizza Place,24.98,debit,Restaurants,Silver Card,Expense,3,2018,2018-03,24.98,24512.93,150.0,16.653333333333332
2018-03-28,Grocery Store,16.06,debit,Groceries,Silver Card,Expense,3,2018,2018-03,16.06,24528.99,150.0,10.706666666666665
2018-03-29,Steakhouse,17.64,debit,Restaurants,Silver Card,Expense,3,2018,2018-03,17.64,24546.63,150.0,11.760000000000002
2018-03-30,Grocery Store,9.09,debit,Groceries,Silver Card,Expense,3,2018,2018-03,9.09,24555.72,150.0,6.0600000000000005
2018-03-30,Biweekly Paycheck,2000.0,credit,Paycheck,Checking,Income,3,2018,2018-03,2000.0,26555.72,,
2018-03-31,Belgian Restaurant,38.32,debit,Restaurants,Platinum Card,Expense,3,2018,2018-03,38.32,26594.04,150.0,25.546666666666667
2018-03-31,Chili's,24.74,debit,Restaurants,Platinum Card,Expense,3,2018,2018-03,24.74,26618.780000000002,150.0,16.493333333333332
2018-03-31,Greek Restaurant,41.16,debit,Restaurants,Silver Card,Expense,3,2018,2018-03,41.16,26659.940000000002,150.0,27.439999999999998
2018-04-01,Grocery Store,80.79,debit,Groceries,Platinum Card,Expense,4,2018,2018-04,80.79,26740.730000000003,150.0,53.86000000000001
2018-04-01,Brewing Company,59.48,debit,Restaurants,Platinum Card,Expense,4,2018,2018-04,59.48,26800.210000000003,150.0,39.65333333333333
2018-04-01,Amazon,13.13,debit,Shopping,Platinum Card,Expense,4,2018,2018-04,13.13,26813.340000000004,100.0,13.13
2018-04-02,Mortgage Payment,1247.44,debit,Mortgage & Rent,Checking,Expense,4,2018,2018-04,1247.44,28060.780000000002,1100.0,113.40363636363637
2018-04-02,Hardware Store,13.89,debit,Home Improvement,Platinum Card,Expense,4,2018,2018-04,13.89,28074.670000000002,250.0,5.556000000000001
2018-04-02,Credit Card Payment,817.14,credit,Credit Card Payment,Silver Card,Income,4,2018,2018-04,817.14,28891.81,,
2018-04-02,Grocery Store,82.36,debit,Groceries,Platinum Card,Expense,4,2018,2018-04,82.36,28974.170000000002,150.0,54.90666666666667
2018-04-03,Amazon Video,6.41,debit,Movies & DVDs,Platinum Card,Expense,4,2018,2018-04,6.41,28980.58,0.0,
2018-04-04,Credit Card Payment,363.08,credit,Credit Card Payment,Platinum Card,Income,4,2018,2018-04,363.08,29343.660000000003,,
2018-04-04,Netflix,11.76,debit,Movies & DVDs,Platinum Card,Expense,4,2018,2018-04,11.76,29355.420000000002,0.0,
2018-04-06,Chevron,4.58,debit,Gas & Fuel,Platinum Card,Expense,4,2018,2018-04,4.58,29360.000000000004,75.0,6.1066666666666665
2018-04-06,Tiny Deli,9.76,debit,Restaurants,Platinum Card,Expense,4,2018,2018-04,9.76,29369.760000000002,150.0,6.506666666666666
2018-04-08,Irish Pub,22.0,debit,Restaurants,Platinum Card,Expense,4,2018,2018-04,22.0,29391.760000000002,150.0,14.666666666666666
2018-04-09,Blue Sky Market,6.48,debit,Groceries,Silver Card,Expense,4,2018,2018-04,6.48,29398.24,150.0,4.32
2018-04-09,Spotify,10.69,debit,Music,Platinum Card,Expense,4,2018,2018-04,10.69,29408.93,11.0,97.18181818181819
2018-04-09,Gas Company,30.0,debit,Utilities,Checking,Expense,4,2018,2018-04,30.0,29438.93,150.0,20.0
2018-04-11,Phone Company,89.52,debit,Mobile Phone,Checking,Expense,4,2018,2018-04,89.52,29528.45,65.0,137.72307692307692
2018-04-12,Barbershop,30.0,debit,Haircut,Platinum Card,Expense,4,2018,2018-04,30.0,29558.45,30.0,100.0
2018-04-12,Starbucks,7.0,debit,Coffee Shops,Platinum Card,Expense,4,2018,2018-04,7.0,29565.45,15.0,46.666666666666664
2018-04-13,BP,37.98,debit,Gas & Fuel,Platinum Card,Expense,4,2018,2018-04,37.98,29603.43,75.0,50.63999999999999
2018-04-13,Biweekly Paycheck,2000.0,credit,Paycheck,Checking,Income,4,2018,2018-04,2000.0,31603.43,,
2018-04-13,American Tavern,10.66,debit,Restaurants,Platinum Card,Expense,4,2018,2018-04,10.66,31614.09,150.0,7.1066666666666665
2018-04-14,Hardware Store,11.61,debit,Home Improvement,Platinum Card,Expense,4,2018,2018-04,11.61,31625.7,250.0,4.643999999999999
2018-04-14,American Tavern,41.0,debit,Restaurants,Platinum Card,Expense,4,2018,2018-04,41.0,31666.7,150.0,27.333333333333332
2018-04-16,State Farm,75.0,debit,Auto Insurance,Checking,Expense,4,2018,2018-04,75.0,31741.7,75.0,100.0
2018-04-16,City Water Charges,35.0,debit,Utilities,Checking,Expense,4,2018,2018-04,35.0,31776.7,150.0,23.333333333333332
2018-04-18,Power Company,60.0,debit,Utilities,Checking,Expense,4,2018,2018-04,60.0,31836.7,150.0,40.0
2018-04-20,Thai Restaurant,24.22,debit,Restaurants,Silver Card,Expense,4,2018,2018-04,24.22,31860.920000000002,150.0,16.146666666666665
2018-04-21,Grocery Store,4.32,debit,Groceries,Silver Card,Expense,4,2018,2018-04,4.32,31865.24,150.0,2.8800000000000003
2018-04-21,American Tavern,35.15,debit,Restaurants,Silver Card,Expense,4,2018,2018-04,35.15,31900.390000000003,150.0,23.43333333333333
2018-04-22,Grocery Store,21.32,debit,Groceries,Platinum Card,Expense,4,2018,2018-04,21.32,31921.710000000003,150.0,14.213333333333333
2018-04-23,Hardware Store,42.7,debit,Home Improvement,Silver Card,Expense,4,2018,2018-04,42.7,31964.410000000003,250.0,17.080000000000002
2018-04-24,Hardware Store,224.7,debit,Home Improvement,Platinum Card,Expense,4,2018,2018-04,224.7,32189.110000000004,250.0,89.88
2018-04-24,Amazon,41.34,debit,Shopping,Platinum Card,Expense,4,2018,2018-04,41.34,32230.450000000004,100.0,41.34
2018-04-25,Hardware Store,210.79,debit,Home Improvement,Silver Card,Expense,4,2018,2018-04,210.79,32441.240000000005,250.0,84.316
2018-04-25,Internet Service Provider,74.99,debit,Internet,Checking,Expense,4,2018,2018-04,74.99,32516.230000000007,75.0,99.98666666666665
2018-04-26,Credit Card Payment,769.72,credit,Credit Card Payment,Silver Card,Income,4,2018,2018-04,769.72,33285.950000000004,,
2018-04-26,Credit Card Payment,1216.94,credit,Credit Card Payment,Platinum Card,Income,4,2018,2018-04,1216.94,34502.89000000001,,
2018-04-27,Credit Card Payment,769.72,debit,Credit Card Payment,Checking,Expense,4,2018,2018-04,769.72,35272.61000000001,,
2018-04-27,Biweekly Paycheck,2000.0,credit,Paycheck,Checking,Income,4,2018,2018-04,2000.0,37272.61000000001,,
2018-04-28,Grocery Store,22.98,debit,Groceries,Silver Card,Expense,4,2018,2018-04,22.98,37295.59000000001,150.0,15.32
2018-04-29,Hardware Store,68.47,debit,Home Improvement,Platinum Card,Expense,4,2018,2018-04,68.47,37364.06000000001,250.0,27.388
2018-04-29,Grocery Store,51.05,debit,Groceries,Platinum Card,Expense,4,2018,2018-04,51.05,37415.110000000015,150.0,34.03333333333333
2018-04-29,QuikTrip,39.0,debit,Gas & Fuel,Platinum Card,Expense,4,2018,2018-04,39.0,37454.110000000015,75.0,52.0
2018-04-30,Grocery Store,5.09,debit,Groceries,Platinum Card,Expense,4,2018,2018-04,5.09,37459.20000000001,150.0,3.393333333333333
2018-05-01,Amazon,13.13,debit,Shopping,Platinum Card,Expense,5,2018,2018-05,13.13,37472.33000000001,100.0,13.13
2018-05-02,Mortgage Payment,1247.44,debit,Mortgage & Rent,Checking,Expense,5,2018,2018-05,1247.44,38719.77000000001,1100.0,113.40363636363637
2018-05-03,Amazon,49.72,debit,Shopping,Platinum Card,Expense,5,2018,2018-05,49.72,38769.49000000001,100.0,49.72
2018-05-04,Grocery Store,42.23,debit,Groceries,Platinum Card,Expense,5,2018,2018-05,42.23,38811.720000000016,150.0,28.15333333333333
2018-05-04,Netflix,11.76,debit,Movies & DVDs,Platinum Card,Expense,5,2018,2018-05,11.76,38823.48000000002,0.0,
2018-05-05,Bojangles,7.27,debit,Fast Food,Platinum Card,Expense,5,2018,2018-05,7.27,38830.750000000015,15.0,48.46666666666666
2018-05-05,Pizza Place,20.52,debit,Fast Food,Platinum Card,Expense,5,2018,2018-05,20.52,38851.27000000001,15.0,136.79999999999998
2018-05-06,Hardware Store,22.37,debit,Home Improvement,Platinum Card,Expense,5,2018,2018-05,22.37,38873.640000000014,250.0,8.948
2018-05-06,Amazon,117.69,debit,Shopping,Platinum Card,Expense,5,2018,2018-05,117.69,38991.330000000016,100.0,117.69000000000001
2018-05-09,Gas Company,30.0,debit,Utilities,Checking,Expense,5,2018,2018-05,30.0,39021.330000000016,150.0,20.0
2018-05-09,Spotify,10.69,debit,Music,Platinum Card,Expense,5,2018,2018-05,10.69,39032.02000000002,11.0,97.18181818181819
2018-05-09,Credit Card Payment,601.4,credit,Credit Card Payment,Platinum Card,Income,5,2018,2018-05,601.4,39633.42000000002,,
2018-05-10,Phone Company,111.18,debit,Mobile Phone,Checking,Expense,5,2018,2018-05,111.18,39744.60000000002,65.0,171.04615384615386
2018-05-11,Grocery Store,57.32,debit,Groceries,Platinum Card,Expense,5,2018,2018-05,57.32,39801.92000000002,150.0,38.21333333333333
2018-05-11,Biweekly Paycheck,2000.0,credit,Paycheck,Checking,Income,5,2018,2018-05,2000.0,41801.92000000002,,
2018-05-11,Mike's Construction Co.,8000.0,debit,Home Improvement,Checking,Expense,5,2018,2018-05,8000.0,49801.92000000002,250.0,3200.0
2018-05-12,Liquor Store,27.77,debit,Alcohol & Bars,Platinum Card,Expense,5,2018,2018-05,27.77,49829.69000000002,50.0,55.54
2018-05-12,Shell,33.3,debit,Gas & Fuel,Platinum Card,Expense,5,2018,2018-05,33.3,49862.99000000002,75.0,44.39999999999999
2018-05-12,Fancy Restaurant,78.0,debit,Restaurants,Platinum Card,Expense,5,2018,2018-05,78.0,49940.99000000002,150.0,52.0
2018-05-14,Grocery Store,67.63,debit,Groceries,Silver Card,Expense,5,2018,2018-05,67.63,50008.62000000002,150.0,45.086666666666666
2018-05-15,Power Company,60.0,debit,Utilities,Checking,Expense,5,2018,2018-05,60.0,50068.62000000002,150.0,40.0
2018-05-17,City Water Charges,35.0,debit,Utilities,Checking,Expense,5,2018,2018-05,35.0,50103.62000000002,150.0,23.333333333333332
2018-05-17,Barbershop,29.0,debit,Haircut,Silver Card,Expense,5,2018,2018-05,29.0,50132.62000000002,30.0,96.66666666666667
2018-05-18,State Farm,75.0,debit,Auto Insurance,Checking,Expense,5,2018,2018-05,75.0,50207.62000000002,75.0,100.0
2018-05-18,Amazon,6.41,debit,Shopping,Platinum Card,Expense,5,2018,2018-05,6.41,50214.03000000002,100.0,6.41
2018-05-19,Credit Card Payment,207.08,credit,Credit Card Payment,Platinum Card,Income,5,2018,2018-05,207.08,50421.11000000002,,
2018-05-19,Grocery Store,31.0,debit,Groceries,Silver Card,Expense,5,2018,2018-05,31.0,50452.11000000002,150.0,20.666666666666668
2018-05-19,Greek Restaurant,23.26,debit,Restaurants,Silver Card,Expense,5,2018,2018-05,23.26,50475.370000000024,150.0,15.506666666666668
2018-05-21,Credit Card Payment,283.07,credit,Credit Card Payment,Silver Card,Income,5,2018,2018-05,283.07,50758.440000000024,,
2018-05-21,Thai Restaurant,26.04,debit,Restaurants,Silver Card,Expense,5,2018,2018-05,26.04,50784.480000000025,150.0,17.36
2018-05-21,Amazon,32.5,debit,Shopping,Platinum Card,Expense,5,2018,2018-05,32.5,50816.980000000025,100.0,32.5
2018-05-22,Credit Card Payment,283.07,debit,Credit Card Payment,Checking,Expense,5,2018,2018-05,283.07,51100.050000000025,,
2018-05-24,BP,39.44,debit,Gas & Fuel,Silver Card,Expense,5,2018,2018-05,39.44,51139.49000000003,75.0,52.58666666666666
2018-05-25,Biweekly Paycheck,2000.0,credit,Paycheck,Checking,Income,5,2018,2018-05,2000.0,53139.49000000003,,
2018-05-25,Internet Service Provider,74.99,debit,Internet,Checking,Expense,5,2018,2018-05,74.99,53214.480000000025,75.0,99.98666666666665
2018-05-28,Movie Theater,9.62,debit,Entertainment,Silver Card,Expense,5,2018,2018-05,9.62,53224.10000000003,25.0,38.48
2018-05-28,Grocery Store,91.03,debit,Groceries,Silver Card,Expense,5,2018,2018-05,91.03,53315.13000000003,150.0,60.68666666666667
2018-05-29,Movie Theater,20.0,debit,Movies & DVDs,Silver Card,Expense,5,2018,2018-05,20.0,53335.13000000003,0.0,
2018-05-29,Movie Theater,6.25,debit,Movies & DVDs,Silver Card,Expense,5,2018,2018-05,6.25,53341.38000000003,0.0,
2018-06-01,BP,38.63,debit,Gas & Fuel,Platinum Card,Expense,6,2018,2018-06,38.63,53380.010000000024,75.0,51.50666666666667
2018-06-01,Grocery Store,6.11,debit,Groceries,Platinum Card,Expense,6,2018,2018-06,6.11,53386.120000000024,150.0,4.073333333333333
2018-06-01,Amazon,13.13,debit,Shopping,Platinum Card,Expense,6,2018,2018-06,13.13,53399.25000000002,100.0,13.13
2018-06-02,Credit Card Payment,235.18,credit,Credit Card Payment,Silver Card,Income,6,2018,2018-06,235.18,53634.43000000002,,
2018-06-02,Credit Card Payment,466.36,credit,Credit Card Payment,Platinum Card,Income,6,2018,2018-06,466.36,54100.79000000002,,
2018-06-03,Italian Restaurant,65.81,debit,Restaurants,Platinum Card,Expense,6,2018,2018-06,65.81,54166.60000000002,150.0,43.873333333333335
2018-06-04,Netflix,11.76,debit,Movies & DVDs,Platinum Card,Expense,6,2018,2018-06,11.76,54178.36000000002,0.0,
2018-06-04,Mortgage Payment,1247.44,debit,Mortgage & Rent,Checking,Expense,6,2018,2018-06,1247.44,55425.800000000025,1100.0,113.40363636363637
2018-06-04,Credit Card Payment,235.18,debit,Credit Card Payment,Checking,Expense,6,2018,2018-06,235.18,55660.980000000025,,
2018-06-04,Grocery Store,24.12,debit,Groceries,Platinum Card,Expense,6,2018,2018-06,24.12,55685.10000000003,150.0,16.08
2018-06-06,Starbucks,4.0,debit,Coffee Shops,Platinum Card,Expense,6,2018,2018-06,4.0,55689.10000000003,15.0,26.666666666666668
2018-06-08,Biweekly Paycheck,2000.0,credit,Paycheck,Checking,Income,6,2018,2018-06,2000.0,57689.10000000003,,
2018-06-08,Gas Company,30.0,debit,Utilities,Checking,Expense,6,2018,2018-06,30.0,57719.10000000003,150.0,20.0
2018-06-09,Chick-Fil-A,16.18,debit,Fast Food,Platinum Card,Expense,6,2018,2018-06,16.18,57735.28000000003,15.0,107.86666666666666
2018-06-09,Grocery Store,9.56,debit,Groceries,Platinum Card,Expense,6,2018,2018-06,9.56,57744.840000000026,150.0,6.373333333333334
2018-06-09,Spotify,10.69,debit,Music,Platinum Card,Expense,6,2018,2018-06,10.69,57755.53000000003,11.0,97.18181818181819
2018-06-10,Grocery Store,46.01,debit,Groceries,Platinum Card,Expense,6,2018,2018-06,46.01,57801.54000000003,150.0,30.673333333333332
2018-06-12,Grocery Store,12.55,debit,Groceries,Platinum Card,Expense,6,2018,2018-06,12.55,57814.09000000003,150.0,8.366666666666667
2018-06-12,Phone Company,89.46,debit,Mobile Phone,Checking,Expense,6,2018,2018-06,89.46,57903.55000000003,65.0,137.63076923076923
2018-06-14,Grocery Store,7.02,debit,Groceries,Platinum Card,Expense,6,2018,2018-06,7.02,57910.57000000003,150.0,4.68
2018-06-14,Credit Card Payment,283.44,credit,Credit Card Payment,Platinum Card,Income,6,2018,2018-06,283.44,58194.01000000003,,
2018-06-15,Power Company,60.0,debit,Utilities,Checking,Expense,6,2018,2018-06,60.0,58254.01000000003,150.0,40.0
2018-06-16,Starbucks,3.0,debit,Coffee Shops,Platinum Card,Expense,6,2018,2018-06,3.0,58257.01000000003,15.0,20.0
2018-06-16,Pizza Place,22.66,debit,Fast Food,Platinum Card,Expense,6,2018,2018-06,22.66,58279.670000000035,15.0,151.06666666666666
2018-06-16,Grocery Store,13.9,debit,Groceries,Platinum Card,Expense,6,2018,2018-06,13.9,58293.570000000036,150.0,9.266666666666667
2018-06-18,City Water Charges,35.0,debit,Utilities,Checking,Expense,6,2018,2018-06,35.0,58328.570000000036,150.0,23.333333333333332
2018-06-19,Shell,38.52,debit,Gas & Fuel,Platinum Card,Expense,6,2018,2018-06,38.52,58367.09000000003,75.0,51.36000000000001
2018-06-19,Grocery Store,2.69,debit,Groceries,Platinum Card,Expense,6,2018,2018-06,2.69,58369.780000000035,150.0,1.7933333333333332
2018-06-20,Barbershop,30.0,debit,Haircut,Silver Card,Expense,6,2018,2018-06,30.0,58399.780000000035,30.0,100.0
2018-06-20,State Farm,75.0,debit,Auto Insurance,Checking,Expense,6,2018,2018-06,75.0,58474.780000000035,75.0,100.0
2018-06-20,Credit Card Payment,89.45,credit,Credit Card Payment,Silver Card,Income,6,2018,2018-06,89.45,58564.23000000003,,
2018-06-21,Credit Card Payment,89.45,debit,Credit Card Payment,Checking,Expense,6,2018,2018-06,89.45,58653.68000000003,,
2018-06-22,Biweekly Paycheck,2000.0,credit,Paycheck,Checking,Income,6,2018,2018-06,2000.0,60653.68000000003,,
2018-06-23,Brunch Restaurant,8.5,debit,Restaurants,Silver Card,Expense,6,2018,2018-06,8.5,60662.18000000003,150.0,5.666666666666666
2018-06-23,Amazon,74.97,debit,Shopping,Platinum Card,Expense,6,2018,2018-06,74.97,60737.15000000003,100.0,74.97
2018-06-25,Credit Card Payment,942.76,credit,Credit Card Payment,Platinum Card,Income,6,2018,2018-06,942.76,61679.91000000003,,
2018-06-25,Internet Service Provider,74.99,debit,Internet,Checking,Expense,6,2018,2018-06,74.99,61754.90000000003,75.0,99.98666666666665
2018-06-26,Grocery Store,9.62,debit,Groceries,Silver Card,Expense,6,2018,2018-06,9.62,61764.52000000003,150.0,6.413333333333333
2018-06-27,Starbucks,3.5,debit,Coffee Shops,Silver Card,Expense,6,2018,2018-06,3.5,61768.02000000003,15.0,23.333333333333332
2018-06-27,Pizza Place,22.66,debit,Fast Food,Platinum Card,Expense,6,2018,2018-06,22.66,61790.68000000004,15.0,151.06666666666666
2018-06-28,Grocery Store,7.57,debit,Groceries,Silver Card,Expense,6,2018,2018-06,7.57,61798.25000000004,150.0,5.046666666666667
2018-07-01,Amazon,13.13,debit,Shopping,Platinum Card,Expense,7,2018,2018-07,13.13,61811.380000000034,100.0,13.13
2018-07-02,Movie Theater,25.0,debit,Movies & DVDs,Silver Card,Expense,7,2018,2018-07,25.0,61836.380000000034,0.0,
2018-07-02,American Tavern,36.44,debit,Restaurants,Silver Card,Expense,7,2018,2018-07,36.44,61872.820000000036,150.0,24.29333333333333
2018-07-02,Mortgage Payment,1247.44,debit,Mortgage & Rent,Checking,Expense,7,2018,2018-07,1247.44,63120.26000000004,1100.0,113.40363636363637
2018-07-04,BP,34.48,debit,Gas & Fuel,Silver Card,Expense,7,2018,2018-07,34.48,63154.74000000004,75.0,45.97333333333333
2018-07-04,Netflix,11.76,debit,Movies & DVDs,Platinum Card,Expense,7,2018,2018-07,11.76,63166.500000000044,0.0,
2018-07-05,Grocery Store,44.25,debit,Groceries,Silver Card,Expense,7,2018,2018-07,44.25,63210.750000000044,150.0,29.5
2018-07-05,Amazon,212.32,debit,Shopping,Platinum Card,Expense,7,2018,2018-07,212.32,63423.07000000004,100.0,212.31999999999996
2018-07-06,Amazon Video,6.41,debit,Movies & DVDs,Platinum Card,Expense,7,2018,2018-07,6.41,63429.48000000005,0.0,
2018-07-06,Biweekly Paycheck,2000.0,credit,Paycheck,Checking,Income,7,2018,2018-07,2000.0,65429.48000000005,,
2018-07-08,Credit Card Payment,259.87,credit,Credit Card Payment,Platinum Card,Income,7,2018,2018-07,259.87,65689.35000000005,,
2018-07-09,Spotify,10.69,debit,Music,Platinum Card,Expense,7,2018,2018-07,10.69,65700.04000000005,11.0,97.18181818181819
2018-07-09,Credit Card Payment,242.16,credit,Credit Card Payment,Silver Card,Income,7,2018,2018-07,242.16,65942.20000000006,,
2018-07-09,Credit Card Payment,259.87,debit,Credit Card Payment,Checking,Expense,7,2018,2018-07,259.87,66202.07000000005,,
2018-07-10,Gas Company,30.0,debit,Utilities,Checking,Expense,7,2018,2018-07,30.0,66232.07000000005,150.0,20.0
2018-07-10,Grocery Store,5.39,debit,Groceries,Silver Card,Expense,7,2018,2018-07,5.39,66237.46000000005,150.0,3.5933333333333333
2018-07-10,Credit Card Payment,242.16,debit,Credit Card Payment,Checking,Expense,7,2018,2018-07,242.16,66479.62000000005,,
2018-07-11,Phone Company,89.46,debit,Mobile Phone,Checking,Expense,7,2018,2018-07,89.46,66569.08000000006,65.0,137.63076923076923
2018-07-14,Go Mart,33.51,debit,Gas & Fuel,Silver Card,Expense,7,2018,2018-07,33.51,66602.59000000005,75.0,44.68
2018-07-15,Circle K,36.24,debit,Gas & Fuel,Platinum Card,Expense,7,2018,2018-07,36.24,66638.83000000006,75.0,48.32
2018-07-17,Wendy's,15.23,debit,Fast Food,Silver Card,Expense,7,2018,2018-07,15.23,66654.06000000006,15.0,101.53333333333335
2018-07-17,City Water Charges,35.0,debit,Utilities,Checking,Expense,7,2018,2018-07,35.0,66689.06000000006,150.0,23.333333333333332
2018-07-17,Power Company,60.0,debit,Utilities,Checking,Expense,7,2018,2018-07,60.0,66749.06000000006,150.0,40.0
2018-07-18,Irish Restaurant,28.54,debit,Alcohol & Bars,Platinum Card,Expense,7,2018,2018-07,28.54,66777.60000000005,50.0,57.08
2018-07-18,State Farm,75.0,debit,Auto Insurance,Checking,Expense,7,2018,2018-07,75.0,66852.60000000005,75.0,100.0
2018-07-20,Credit Card Payment,102.88,credit,Credit Card Payment,Platinum Card,Income,7,2018,2018-07,102.88,66955.48000000005,,
2018-07-20,Biweekly Paycheck,2000.0,credit,Paycheck,Checking,Income,7,2018,2018-07,2000.0,68955.48000000005,,
2018-07-20,Credit Card Payment,61.43,credit,Credit Card Payment,Silver Card,Income,7,2018,2018-07,61.43,69016.91000000005,,
2018-07-21,Grocery Store,28.93,debit,Groceries,Platinum Card,Expense,7,2018,2018-07,28.93,69045.84000000004,150.0,19.286666666666665
2018-07-21,Barbershop,30.0,debit,Haircut,Platinum Card,Expense,7,2018,2018-07,30.0,69075.84000000004,30.0,100.0
2018-07-23,Credit Card Payment,61.43,debit,Credit Card Payment,Checking,Expense,7,2018,2018-07,61.43,69137.27000000003,,
2018-07-23,Starbucks,9.58,debit,Fast Food,Platinum Card,Expense,7,2018,2018-07,9.58,69146.85000000003,15.0,63.866666666666674
2018-07-24,American Tavern,26.59,debit,Restaurants,Platinum Card,Expense,7,2018,2018-07,26.59,69173.44000000003,150.0,17.726666666666667
2018-07-25,Internet Service Provider,74.99,debit,Internet,Checking,Expense,7,2018,2018-07,74.99,69248.43000000004,75.0,99.98666666666665
2018-07-26,Conoco,33.67,debit,Gas & Fuel,Silver Card,Expense,7,2018,2018-07,33.67,69282.10000000003,75.0,44.89333333333334
2018-07-28,Grocery Store,7.61,debit,Groceries,Silver Card,Expense,7,2018,2018-07,7.61,69289.71000000004,150.0,5.073333333333334
2018-07-30,American Tavern,34.38,debit,Restaurants,Silver Card,Expense,7,2018,2018-07,34.38,69324.09000000004,150.0,22.92
2018-07-31,Brewing Company,6.6,debit,Alcohol & Bars,Silver Card,Expense,7,2018,2018-07,6.6,69330.69000000005,50.0,13.200000000000001
2018-08-01,Amazon,13.13,debit,Shopping,Platinum Card,Expense,8,2018,2018-08,13.13,69343.82000000005,100.0,13.13
2018-08-02,Mortgage Payment,1247.44,debit,Mortgage & Rent,Checking,Expense,8,2018,2018-08,1247.44,70591.26000000005,1100.0,113.40363636363637
2018-08-02,Credit Card Payment,816.27,credit,Credit Card Payment,Platinum Card,Income,8,2018,2018-08,816.27,71407.53000000006,,
2018-08-02,Shell,40.44,debit,Gas & Fuel,Silver Card,Expense,8,2018,2018-08,40.44,71447.97000000006,75.0,53.92
2018-08-03,Grocery Store,6.27,debit,Groceries,Silver Card,Expense,8,2018,2018-08,6.27,71454.24000000006,150.0,4.18
2018-08-03,Biweekly Paycheck,2000.0,credit,Paycheck,Checking,Income,8,2018,2018-08,2000.0,73454.24000000006,,
2018-08-04,Netflix,11.76,debit,Movies & DVDs,Platinum Card,Expense,8,2018,2018-08,11.76,73466.00000000006,0.0,
2018-08-06,Amazon,76.47,debit,Shopping,Platinum Card,Expense,8,2018,2018-08,76.47,73542.47000000006,100.0,76.47
2018-08-09,Spotify,10.69,debit,Music,Platinum Card,Expense,8,2018,2018-08,10.69,73553.16000000006,11.0,97.18181818181819
2018-08-09,Gas Company,30.0,debit,Utilities,Checking,Expense,8,2018,2018-08,30.0,73583.16000000006,150.0,20.0
2018-08-10,Phone Company,89.4,debit,Mobile Phone,Checking,Expense,8,2018,2018-08,89.4,73672.56000000006,65.0,137.53846153846155
2018-08-11,Valero,33.66,debit,Gas & Fuel,Platinum Card,Expense,8,2018,2018-08,33.66,73706.22000000006,75.0,44.879999999999995
2018-08-11,Chick-Fil-A,13.67,debit,Fast Food,Platinum Card,Expense,8,2018,2018-08,13.67,73719.89000000006,15.0,91.13333333333333
2018-08-15,Power Company,60.0,debit,Utilities,Checking,Expense,8,2018,2018-08,60.0,73779.89000000006,150.0,40.0
2018-08-15,Grocery Store,5.64,debit,Groceries,Platinum Card,Expense,8,2018,2018-08,5.64,73785.53000000006,150.0,3.7599999999999993
2018-08-15,Credit Card Payment,269.56,credit,Credit Card Payment,Silver Card,Income,8,2018,2018-08,269.56,74055.09000000005,,
2018-08-15,Credit Card Payment,159.38,credit,Credit Card Payment,Platinum Card,Income,8,2018,2018-08,159.38,74214.47000000006,,
2018-08-15,Shell,41.07,debit,Gas & Fuel,Platinum Card,Expense,8,2018,2018-08,41.07,74255.54000000007,75.0,54.76
2018-08-16,Credit Card Payment,269.56,debit,Credit Card Payment,Checking,Expense,8,2018,2018-08,269.56,74525.10000000006,,
2018-08-16,City Water Charges,35.0,debit,Utilities,Checking,Expense,8,2018,2018-08,35.0,74560.10000000006,150.0,23.333333333333332
2018-08-17,Amazon,14.98,debit,Shopping,Platinum Card,Expense,8,2018,2018-08,14.98,74575.08000000006,100.0,14.980000000000002
2018-08-17,Biweekly Paycheck,2000.0,credit,Paycheck,Checking,Income,8,2018,2018-08,2000.0,76575.08000000006,,
2018-08-18,Amazon,23.47,debit,Shopping,Platinum Card,Expense,8,2018,2018-08,23.47,76598.55000000006,100.0,23.47
2018-08-20,State Farm,75.0,debit,Auto Insurance,Checking,Expense,8,2018,2018-08,75.0,76673.55000000006,75.0,100.0
2018-08-21,Credit Card Payment,99.76,credit,Credit Card Payment,Platinum Card,Income,8,2018,2018-08,99.76,76773.31000000006,,
2018-08-21,Credit Card Payment,34.18,credit,Credit Card Payment,Silver Card,Income,8,2018,2018-08,34.18,76807.49000000005,,
2018-08-22,Credit Card Payment,34.18,debit,Credit Card Payment,Checking,Expense,8,2018,2018-08,34.18,76841.67000000004,,
2018-08-24,American Tavern,42.31,debit,Restaurants,Platinum Card,Expense,8,2018,2018-08,42.31,76883.98000000004,150.0,28.20666666666667
2018-08-27,Internet Service Provider,74.99,debit,Internet,Checking,Expense,8,2018,2018-08,74.99,76958.97000000004,75.0,99.98666666666665
2018-08-30,Shell,35.65,debit,Gas & Fuel,Platinum Card,Expense,8,2018,2018-08,35.65,76994.62000000004,75.0,47.53333333333333
2018-08-31,Grocery Store,11.64,debit,Groceries,Platinum Card,Expense,8,2018,2018-08,11.64,77006.26000000004,150.0,7.76
2018-08-31,Biweekly Paycheck,2000.0,credit,Paycheck,Checking,Income,8,2018,2018-08,2000.0,79006.26000000004,,
2018-09-01,Brewing Company,47.4,debit,Alcohol & Bars,Platinum Card,Expense,9,2018,2018-09,47.4,79053.66000000003,50.0,94.8
2018-09-01,Amazon,13.13,debit,Shopping,Platinum Card,Expense,9,2018,2018-09,13.13,79066.79000000004,100.0,13.13
2018-09-02,Amazon,109.83,debit,Shopping,Platinum Card,Expense,9,2018,2018-09,109.83,79176.62000000004,100.0,109.83000000000001
2018-09-04,Netflix,11.76,debit,Movies & DVDs,Platinum Card,Expense,9,2018,2018-09,11.76,79188.38000000003,0.0,
2018-09-04,Credit Card Payment,687.29,credit,Credit Card Payment,Platinum Card,Income,9,2018,2018-09,687.29,79875.67000000003,,
2018-09-04,Mortgage Payment,1247.44,debit,Mortgage & Rent,Checking,Expense,9,2018,2018-09,1247.44,81123.11000000003,1100.0,113.40363636363637
2018-09-07,Gas Company,30.0,debit,Utilities,Checking,Expense,9,2018,2018-09,30.0,81153.11000000003,150.0,20.0
2018-09-09,Brewing Company,18.0,debit,Alcohol & Bars,Platinum Card,Expense,9,2018,2018-09,18.0,81171.11000000003,50.0,36.0
2018-09-09,Spotify,10.69,debit,Music,Platinum Card,Expense,9,2018,2018-09,10.69,81181.80000000003,11.0,97.18181818181819
2018-09-11,BP,38.86,debit,Gas & Fuel,Platinum Card,Expense,9,2018,2018-09,38.86,81220.66000000003,75.0,51.81333333333333
2018-09-11,Grocery Store,7.87,debit,Groceries,Platinum Card,Expense,9,2018,2018-09,7.87,81228.53000000003,150.0,5.246666666666667
2018-09-12,Phone Company,89.4,debit,Mobile Phone,Checking,Expense,9,2018,2018-09,89.4,81317.93000000002,65.0,137.53846153846155
2018-09-12,Grocery Store,47.16,debit,Groceries,Platinum Card,Expense,9,2018,2018-09,47.16,81365.09000000003,150.0,31.439999999999994
2018-09-13,Grocery Store,5.64,debit,Groceries,Platinum Card,Expense,9,2018,2018-09,5.64,81370.73000000003,150.0,3.7599999999999993
2018-09-14,Biweekly Paycheck,2000.0,credit,Paycheck,Checking,Income,9,2018,2018-09,2000.0,83370.73000000003,,
2018-09-14,Credit Card Payment,134.34,credit,Credit Card Payment,Platinum Card,Income,9,2018,2018-09,134.34,83505.07000000002,,
2018-09-17,Grocery Store,10.17,debit,Groceries,Platinum Card,Expense,9,2018,2018-09,10.17,83515.24000000002,150.0,6.78
2018-09-17,Grocery Store,8.8,debit,Groceries,Platinum Card,Expense,9,2018,2018-09,8.8,83524.04000000002,150.0,5.866666666666667
2018-09-17,City Water Charges,35.0,debit,Utilities,Checking,Expense,9,2018,2018-09,35.0,83559.04000000002,150.0,23.333333333333332
2018-09-18,Grocery Store,4.32,debit,Groceries,Platinum Card,Expense,9,2018,2018-09,4.32,83563.36000000003,150.0,2.8800000000000003
2018-09-18,Power Company,60.0,debit,Utilities,Checking,Expense,9,2018,2018-09,60.0,83623.36000000003,150.0,40.0
2018-09-19,State Farm,75.0,debit,Auto Insurance,Checking,Expense,9,2018,2018-09,75.0,83698.36000000003,75.0,100.0
2018-09-19,Barbershop,30.0,debit,Haircut,Platinum Card,Expense,9,2018,2018-09,30.0,83728.36000000003,30.0,100.0
2018-09-20,Amazon,47.38,debit,Shopping,Platinum Card,Expense,9,2018,2018-09,47.38,83775.74000000003,100.0,47.38
2018-09-22,Hardware Store,69.4,debit,Home Improvement,Platinum Card,Expense,9,2018,2018-09,69.4,83845.14000000003,250.0,27.76
2018-09-22,Hardware Store,6.83,debit,Home Improvement,Platinum Card,Expense,9,2018,2018-09,6.83,83851.97000000003,250.0,2.732
2018-09-25,Sushi Restaurant,48.64,debit,Restaurants,Silver Card,Expense,9,2018,2018-09,48.64,83900.61000000003,150.0,32.42666666666666
2018-09-25,Internet Service Provider,74.99,debit,Internet,Checking,Expense,9,2018,2018-09,74.99,83975.60000000003,75.0,99.98666666666665
2018-09-26,Starbucks,5.0,debit,Coffee Shops,Platinum Card,Expense,9,2018,2018-09,5.0,83980.60000000003,15.0,33.33333333333333
2018-09-26,Exxon,38.0,debit,Gas & Fuel,Silver Card,Expense,9,2018,2018-09,38.0,84018.60000000003,75.0,50.66666666666667
2018-09-27,Valero,40.71,debit,Gas & Fuel,Platinum Card,Expense,9,2018,2018-09,40.71,84059.31000000004,75.0,54.28000000000001
2018-09-28,Credit Card Payment,128.12,credit,Credit Card Payment,Silver Card,Income,9,2018,2018-09,128.12,84187.43000000004,,
2018-09-28,Credit Card Payment,284.96,credit,Credit Card Payment,Platinum Card,Income,9,2018,2018-09,284.96,84472.39000000004,,
2018-09-28,Grocery Store,13.36,debit,Groceries,Platinum Card,Expense,9,2018,2018-09,13.36,84485.75000000004,150.0,8.906666666666666
2018-09-28,Biweekly Paycheck,2000.0,credit,Paycheck,Checking,Income,9,2018,2018-09,2000.0,86485.75000000004,,
2018-09-29,German Restaurant,46.7,debit,Restaurants,Platinum Card,Expense,9,2018,2018-09,46.7,86532.45000000004,150.0,31.133333333333336
2018-09-29,Greek Restaurant,23.26,debit,Restaurants,Platinum Card,Expense,9,2018,2018-09,23.26,86555.71000000004,150.0,15.506666666666668
2018-10-01,Grocery Store,15.66,debit,Groceries,Platinum Card,Expense,10,2018,2018-10,15.66,86571.37000000004,150.0,10.440000000000001
2018-10-01,Amazon,13.13,debit,Shopping,Platinum Card,Expense,10,2018,2018-10,13.13,86584.50000000004,100.0,13.13
2018-10-01,Starbucks,3.0,debit,Coffee Shops,Platinum Card,Expense,10,2018,2018-10,3.0,86587.50000000004,15.0,20.0
2018-10-01,Credit Card Payment,128.12,debit,Credit Card Payment,Checking,Expense,10,2018,2018-10,128.12,86715.62000000004,,
2018-10-02,Credit Card Payment,124.03,credit,Credit Card Payment,Platinum Card,Income,10,2018,2018-10,124.03,86839.65000000004,,
2018-10-02,Mortgage Payment,1209.18,debit,Mortgage & Rent,Checking,Expense,10,2018,2018-10,1209.18,88048.83000000003,1100.0,109.92545454545454
2018-10-04,Netflix,11.76,debit,Movies & DVDs,Platinum Card,Expense,10,2018,2018-10,11.76,88060.59000000003,0.0,
2018-10-06,American Tavern,27.0,debit,Restaurants,Silver Card,Expense,10,2018,2018-10,27.0,88087.59000000003,150.0,18.0
2018-10-08,Shell,38.06,debit,Gas & Fuel,Silver Card,Expense,10,2018,2018-10,38.06,88125.65000000002,75.0,50.74666666666667
2018-10-08,Hardware Store,80.65,debit,Home Improvement,Silver Card,Expense,10,2018,2018-10,80.65,88206.30000000002,250.0,32.26
2018-10-08,Hardware Store,31.2,debit,Home Improvement,Silver Card,Expense,10,2018,2018-10,31.2,88237.50000000001,250.0,12.479999999999999
2018-10-09,Gas Company,30.0,debit,Utilities,Checking,Expense,10,2018,2018-10,30.0,88267.50000000001,150.0,20.0
2018-10-09,Amazon,19.98,debit,Shopping,Platinum Card,Expense,10,2018,2018-10,19.98,88287.48000000001,100.0,19.98
2018-10-09,Spotify,10.69,debit,Music,Platinum Card,Expense,10,2018,2018-10,10.69,88298.17000000001,11.0,97.18181818181819
2018-10-10,Grocery Store,53.68,debit,Groceries,Silver Card,Expense,10,2018,2018-10,53.68,88351.85,150.0,35.78666666666667
2018-10-11,Phone Company,89.4,debit,Mobile Phone,Checking,Expense,10,2018,2018-10,89.4,88441.25,65.0,137.53846153846155
2018-10-12,Biweekly Paycheck,2000.0,credit,Paycheck,Checking,Income,10,2018,2018-10,2000.0,90441.25,,
2018-10-16,Power Company,60.0,debit,Utilities,Checking,Expense,10,2018,2018-10,60.0,90501.25,150.0,40.0
2018-10-17,City Water Charges,35.0,debit,Utilities,Checking,Expense,10,2018,2018-10,35.0,90536.25,150.0,23.333333333333332
2018-10-18,State Farm,75.0,debit,Auto Insurance,Checking,Expense,10,2018,2018-10,75.0,90611.25,75.0,100.0
2018-10-18,Grocery Store,33.55,debit,Groceries,Platinum Card,Expense,10,2018,2018-10,33.55,90644.8,150.0,22.366666666666664
2018-10-18,Hardware Store,45.24,debit,Home Improvement,Platinum Card,Expense,10,2018,2018-10,45.24,90690.04000000001,250.0,18.096
2018-10-18,Brunch Restaurant,8.0,debit,Restaurants,Platinum Card,Expense,10,2018,2018-10,8.0,90698.04000000001,150.0,5.333333333333334
2018-10-21,Credit Card Payment,544.37,credit,Credit Card Payment,Platinum Card,Income,10,2018,2018-10,544.37,91242.41,,
2018-10-22,BP,34.66,debit,Gas & Fuel,Platinum Card,Expense,10,2018,2018-10,34.66,91277.07,75.0,46.21333333333333
2018-10-22,Credit Card Payment,353.83,credit,Credit Card Payment,Silver Card,Income,10,2018,2018-10,353.83,91630.90000000001,,
2018-10-23,Grocery Store,7.57,debit,Groceries,Platinum Card,Expense,10,2018,2018-10,7.57,91638.47000000002,150.0,5.046666666666667
2018-10-25,Internet Service Provider,74.99,debit,Internet,Checking,Expense,10,2018,2018-10,74.99,91713.46000000002,75.0,99.98666666666665
2018-10-25,Amazon,29.98,debit,Shopping,Platinum Card,Expense,10,2018,2018-10,29.98,91743.44000000002,100.0,29.98
2018-10-26,Biweekly Paycheck,2000.0,credit,Paycheck,Checking,Income,10,2018,2018-10,2000.0,93743.44000000002,,
2018-10-27,American Tavern,25.4,debit,Restaurants,Silver Card,Expense,10,2018,2018-10,25.4,93768.84000000001,150.0,16.933333333333334
2018-10-28,Brewing Company,12.71,debit,Alcohol & Bars,Platinum Card,Expense,10,2018,2018-10,12.71,93781.55000000002,50.0,25.420000000000005
2018-10-28,Seafood Restaurant,14.75,debit,Food & Dining,Platinum Card,Expense,10,2018,2018-10,14.75,93796.30000000002,,
2018-10-28,Grocery Store,92.49,debit,Groceries,Platinum Card,Expense,10,2018,2018-10,92.49,93888.79000000002,150.0,61.65999999999999
2018-10-28,Italian Restaurant,54.0,debit,Restaurants,Platinum Card,Expense,10,2018,2018-10,54.0,93942.79000000002,150.0,36.0
2018-10-31,Grocery Store,5.64,debit,Groceries,Platinum Card,Expense,10,2018,2018-10,5.64,93948.43000000002,150.0,3.7599999999999993
2018-11-01,Amazon,13.13,debit,Shopping,Platinum Card,Expense,11,2018,2018-11,13.13,93961.56000000003,100.0,13.13
2018-11-02,Mortgage Payment,1209.18,debit,Mortgage & Rent,Checking,Expense,11,2018,2018-11,1209.18,95170.74000000002,1100.0,109.92545454545454
2018-11-02,Credit Card Payment,262.51,credit,Credit Card Payment,Platinum Card,Income,11,2018,2018-11,262.51,95433.25000000001,,
2018-11-03,Pizza Place,23.66,debit,Fast Food,Platinum Card,Expense,11,2018,2018-11,23.66,95456.91000000002,15.0,157.73333333333332
2018-11-04,Netflix,11.76,debit,Movies & DVDs,Platinum Card,Expense,11,2018,2018-11,11.76,95468.67000000001,0.0,
2018-11-05,Shell,36.51,debit,Gas & Fuel,Platinum Card,Expense,11,2018,2018-11,36.51,95505.18000000001,75.0,48.67999999999999
2018-11-06,Amazon,53.95,debit,Shopping,Platinum Card,Expense,11,2018,2018-11,53.95,95559.13,100.0,53.949999999999996
2018-11-06,Gas Company,30.0,debit,Utilities,Checking,Expense,11,2018,2018-11,30.0,95589.13,150.0,20.0
2018-11-08,Grocery Store,5.64,debit,Groceries,Platinum Card,Expense,11,2018,2018-11,5.64,95594.77,150.0,3.7599999999999993
2018-11-09,Spotify,10.69,debit,Music,Platinum Card,Expense,11,2018,2018-11,10.69,95605.46,11.0,97.18181818181819
2018-11-09,Biweekly Paycheck,2000.0,credit,Paycheck,Checking,Income,11,2018,2018-11,2000.0,97605.46,,
2018-11-10,Chick-Fil-A,14.19,debit,Fast Food,Platinum Card,Expense,11,2018,2018-11,14.19,97619.65000000001,15.0,94.6
2018-11-10,Brewing Company,27.0,debit,Alcohol & Bars,Platinum Card,Expense,11,2018,2018-11,27.0,97646.65000000001,50.0,54.0
2018-11-10,Food Truck,24.4,debit,Groceries,Platinum Card,Expense,11,2018,2018-11,24.4,97671.05,150.0,16.266666666666666
2018-11-12,American Tavern,22.33,debit,Restaurants,Silver Card,Expense,11,2018,2018-11,22.33,97693.38,150.0,14.886666666666665
2018-11-12,Grocery Store,10.18,debit,Groceries,Platinum Card,Expense,11,2018,2018-11,10.18,97703.56,150.0,6.786666666666666
2018-11-13,Grocery Store,10.15,debit,Groceries,Platinum Card,Expense,11,2018,2018-11,10.15,97713.70999999999,150.0,6.766666666666667
2018-11-13,Phone Company,89.54,debit,Mobile Phone,Checking,Expense,11,2018,2018-11,89.54,97803.24999999999,65.0,137.75384615384615
2018-11-13,Grocery Store,4.8,debit,Groceries,Platinum Card,Expense,11,2018,2018-11,4.8,97808.04999999999,150.0,3.2
2018-11-13,Grocery Store,37.43,debit,Groceries,Platinum Card,Expense,11,2018,2018-11,37.43,97845.47999999998,150.0,24.953333333333333
2018-11-14,Power Company,60.0,debit,Utilities,Checking,Expense,11,2018,2018-11,60.0,97905.47999999998,150.0,40.0
2018-11-16,City Water Charges,35.0,debit,Utilities,Checking,Expense,11,2018,2018-11,35.0,97940.47999999998,150.0,23.333333333333332
2018-11-17,Brewing Company,22.8,debit,Alcohol & Bars,Platinum Card,Expense,11,2018,2018-11,22.8,97963.27999999998,50.0,45.6
2018-11-17,Hardware Store,15.47,debit,Home Improvement,Platinum Card,Expense,11,2018,2018-11,15.47,97978.74999999999,250.0,6.188000000000001
2018-11-17,Hardware Store,6.4,debit,Home Improvement,Platinum Card,Expense,11,2018,2018-11,6.4,97985.14999999998,250.0,2.56
2018-11-17,Greek Restaurant,23.26,debit,Restaurants,Platinum Card,Expense,11,2018,2018-11,23.26,98008.40999999997,150.0,15.506666666666668
2018-11-19,Brewing Company,20.0,debit,Alcohol & Bars,Silver Card,Expense,11,2018,2018-11,20.0,98028.40999999997,50.0,40.0
2018-11-19,QuikTrip,29.15,debit,Gas & Fuel,Silver Card,Expense,11,2018,2018-11,29.15,98057.55999999997,75.0,38.86666666666667
2018-11-19,Hardware Store,10.02,debit,Home Improvement,Silver Card,Expense,11,2018,2018-11,10.02,98067.57999999997,250.0,4.008
2018-11-20,State Farm,75.0,debit,Auto Insurance,Checking,Expense,11,2018,2018-11,75.0,98142.57999999997,75.0,100.0
2018-11-20,Credit Card Payment,421.96,credit,Credit Card Payment,Platinum Card,Income,11,2018,2018-11,421.96,98564.53999999998,,
2018-11-21,Hardware Store,37.41,debit,Home Improvement,Platinum Card,Expense,11,2018,2018-11,37.41,98601.94999999998,250.0,14.963999999999999
2018-11-21,Grocery Store,5.64,debit,Groceries,Silver Card,Expense,11,2018,2018-11,5.64,98607.58999999998,150.0,3.7599999999999993
2018-11-23,Biweekly Paycheck,2000.0,credit,Paycheck,Checking,Income,11,2018,2018-11,2000.0,100607.58999999998,,
2018-11-26,American Tavern,16.8,debit,Alcohol & Bars,Silver Card,Expense,11,2018,2018-11,16.8,100624.38999999998,50.0,33.6
2018-11-26,Internet Service Provider,74.99,debit,Internet,Checking,Expense,11,2018,2018-11,74.99,100699.37999999999,75.0,99.98666666666665
2018-11-27,Movie Theater,17.0,debit,Movies & DVDs,Silver Card,Expense,11,2018,2018-11,17.0,100716.37999999999,0.0,
2018-11-27,American Tavern,28.4,debit,Restaurants,Silver Card,Expense,11,2018,2018-11,28.4,100744.77999999998,150.0,18.933333333333334
2018-11-29,Credit Card Payment,582.99,credit,Credit Card Payment,Silver Card,Income,11,2018,2018-11,582.99,101327.76999999999,,
2018-11-29,Credit Card Payment,751.5,credit,Credit Card Payment,Platinum Card,Income,11,2018,2018-11,751.5,102079.26999999999,,
2018-11-30,Credit Card Payment,582.99,debit,Credit Card Payment,Checking,Expense,11,2018,2018-11,582.99,102662.26,,
2018-11-30,Grocery Store,6.27,debit,Groceries,Silver Card,Expense,11,2018,2018-11,6.27,102668.53,150.0,4.18
2018-12-01,Brunch Restaurant,8.0,debit,Restaurants,Silver Card,Expense,12,2018,2018-12,8.0,102676.53,150.0,5.333333333333334
2018-12-01,Amazon,13.13,debit,Shopping,Platinum Card,Expense,12,2018,2018-12,13.13,102689.66,100.0,13.13
2018-12-01,Grocery Store,5.64,debit,Groceries,Silver Card,Expense,12,2018,2018-12,5.64,102695.3,150.0,3.7599999999999993
2018-12-03,BP,30.03,debit,Gas & Fuel,Silver Card,Expense,12,2018,2018-12,30.03,102725.33,75.0,40.040000000000006
2018-12-03,Grocery Store,148.15,debit,Groceries,Silver Card,Expense,12,2018,2018-12,148.15,102873.48,150.0,98.76666666666667
2018-12-03,Mortgage Payment,1209.18,debit,Mortgage & Rent,Checking,Expense,12,2018,2018-12,1209.18,104082.65999999999,1100.0,109.92545454545454
2018-12-04,Starbucks,3.0,debit,Coffee Shops,Silver Card,Expense,12,2018,2018-12,3.0,104085.65999999999,15.0,20.0
2018-12-04,Latin Restaurant,20.65,debit,Fast Food,Platinum Card,Expense,12,2018,2018-12,20.65,104106.30999999998,15.0,137.66666666666666
2018-12-04,Netflix,11.76,debit,Movies & DVDs,Platinum Card,Expense,12,2018,2018-12,11.76,104118.06999999998,0.0,
2018-12-06,Grocery Store,21.38,debit,Groceries,Platinum Card,Expense,12,2018,2018-12,21.38,104139.44999999998,150.0,14.253333333333332
2018-12-06,Grocery Store,13.48,debit,Groceries,Platinum Card,Expense,12,2018,2018-12,13.48,104152.92999999998,150.0,8.986666666666666
2018-12-06,Gas Company,40.0,debit,Utilities,Checking,Expense,12,2018,2018-12,40.0,104192.92999999998,150.0,26.666666666666668
2018-12-07,Biweekly Paycheck,2000.0,credit,Paycheck,Checking,Income,12,2018,2018-12,2000.0,106192.92999999998,,
2018-12-07,Barbershop,30.0,debit,Haircut,Platinum Card,Expense,12,2018,2018-12,30.0,106222.92999999998,30.0,100.0
2018-12-08,Grocery Store,12.64,debit,Groceries,Platinum Card,Expense,12,2018,2018-12,12.64,106235.56999999998,150.0,8.426666666666668
2018-12-09,Spotify,10.69,debit,Music,Platinum Card,Expense,12,2018,2018-12,10.69,106246.25999999998,11.0,97.18181818181819
2018-12-11,Brunch Restaurant,10.29,debit,Restaurants,Platinum Card,Expense,12,2018,2018-12,10.29,106256.54999999997,150.0,6.859999999999999
2018-12-12,Phone Company,89.54,debit,Mobile Phone,Checking,Expense,12,2018,2018-12,89.54,106346.08999999997,65.0,137.75384615384615
2018-12-13,Thai Restaurant,27.0,debit,Restaurants,Silver Card,Expense,12,2018,2018-12,27.0,106373.08999999997,150.0,18.0
2018-12-14,Grocery Store,21.39,debit,Groceries,Silver Card,Expense,12,2018,2018-12,21.39,106394.47999999997,150.0,14.26
2018-12-14,Hardware Store,17.1,debit,Home Improvement,Silver Card,Expense,12,2018,2018-12,17.1,106411.57999999997,250.0,6.84
2018-12-14,Power Company,60.0,debit,Utilities,Checking,Expense,12,2018,2018-12,60.0,106471.57999999997,150.0,40.0
2018-12-17,American Tavern,63.0,debit,Food & Dining,Silver Card,Expense,12,2018,2018-12,63.0,106534.57999999997,,
2018-12-17,BP,20.01,debit,Gas & Fuel,Silver Card,Expense,12,2018,2018-12,20.01,106554.58999999997,75.0,26.680000000000003
2018-12-17,City Water Charges,35.0,debit,Utilities,Checking,Expense,12,2018,2018-12,35.0,106589.58999999997,150.0,23.333333333333332
2018-12-18,Amazon,41.72,debit,Shopping,Platinum Card,Expense,12,2018,2018-12,41.72,106631.30999999997,100.0,41.72
2018-12-18,Amazon,24.3,debit,Shopping,Platinum Card,Expense,12,2018,2018-12,24.3,106655.60999999997,100.0,24.3
2018-12-18,Amazon,49.99,debit,Shopping,Platinum Card,Expense,12,2018,2018-12,49.99,106705.59999999998,100.0,49.99
2018-12-18,Starbucks,3.0,debit,Coffee Shops,Silver Card,Expense,12,2018,2018-12,3.0,106708.59999999998,15.0,20.0
2018-12-18,Credit Card Payment,311.02,credit,Credit Card Payment,Platinum Card,Income,12,2018,2018-12,311.02,107019.61999999998,,
2018-12-18,Fancy Restaurant,56.52,debit,Restaurants,Silver Card,Expense,12,2018,2018-12,56.52,107076.13999999998,150.0,37.68
2018-12-19,State Farm,75.0,debit,Auto Insurance,Checking,Expense,12,2018,2018-12,75.0,107151.13999999998,75.0,100.0
2018-12-19,Amazon,43.01,debit,Shopping,Platinum Card,Expense,12,2018,2018-12,43.01,107194.14999999998,100.0,43.01
2018-12-20,Credit Card Payment,464.03,credit,Credit Card Payment,Silver Card,Income,12,2018,2018-12,464.03,107658.17999999998,,
2018-12-20,Shell,30.38,debit,Gas & Fuel,Silver Card,Expense,12,2018,2018-12,30.38,107688.55999999998,75.0,40.50666666666666
2018-12-21,Credit Card Payment,464.03,debit,Credit Card Payment,Checking,Expense,12,2018,2018-12,464.03,108152.58999999998,,
2018-12-21,Biweekly Paycheck,2000.0,credit,Paycheck,Checking,Income,12,2018,2018-12,2000.0,110152.58999999998,,
2018-12-22,New York Deli,21.38,debit,Fast Food,Platinum Card,Expense,12,2018,2018-12,21.38,110173.96999999999,15.0,142.53333333333333
2018-12-22,Hardware Store,22.14,debit,Home Improvement,Platinum Card,Expense,12,2018,2018-12,22.14,110196.10999999999,250.0,8.856
2018-12-23,Hardware Store,28.0,debit,Home Improvement,Platinum Card,Expense,12,2018,2018-12,28.0,110224.10999999999,250.0,11.200000000000001
2018-12-24,Hardware Store,38.4,debit,Home Improvement,Platinum Card,Expense,12,2018,2018-12,38.4,110262.50999999998,250.0,15.36
2018-12-26,Chick-Fil-A,56.07,debit,Fast Food,Platinum Card,Expense,12,2018,2018-12,56.07,110318.57999999999,15.0,373.8
2018-12-26,Shell,32.47,debit,Gas & Fuel,Platinum Card,Expense,12,2018,2018-12,32.47,110351.04999999999,75.0,43.29333333333334
2018-12-26,Shell,7.48,debit,Gas & Fuel,Platinum Card,Expense,12,2018,2018-12,7.48,110358.52999999998,75.0,9.973333333333334
2018-12-26,Internet Service Provider,75.99,debit,Internet,Checking,Expense,12,2018,2018-12,75.99,110434.51999999999,75.0,101.32
2018-12-26,Amazon,44.99,debit,Shopping,Platinum Card,Expense,12,2018,2018-12,44.99,110479.51,100.0,44.99
2018-12-28,Brewing Company,12.0,debit,Alcohol & Bars,Silver Card,Expense,12,2018,2018-12,12.0,110491.51,50.0,24.0
2018-12-29,Brewing Company,14.0,debit,Alcohol & Bars,Silver Card,Expense,12,2018,2018-12,14.0,110505.51,50.0,28.000000000000004
2018-12-29,Credit Card Payment,860.05,credit,Credit Card Payment,Platinum Card,Income,12,2018,2018-12,860.05,111365.56,,
2018-12-29,Grocery Store,55.04,debit,Groceries,Silver Card,Expense,12,2018,2018-12,55.04,111420.59999999999,150.0,36.693333333333335
2019-01-01,Amazon,13.09,debit,Shopping,Platinum Card,Expense,1,2019,2019-01,13.09,111433.68999999999,100.0,13.089999999999998
2019-01-02,Credit Card Payment,499.6,debit,Credit Card Payment,Checking,Expense,1,2019,2019-01,499.6,111933.29,,
2019-01-03,Mortgage Payment,1100.0,debit,Mortgage & Rent,Checking,Expense,1,2019,2019-01,1100.0,113033.29,1100.0,100.0
2019-01-03,Amazon,42.1,debit,Shopping,Platinum Card,Expense,1,2019,2019-01,42.1,113075.39,100.0,42.1
2019-01-04,Biweekly Paycheck,2000.0,credit,Paycheck,Checking,Income,1,2019,2019-01,2000.0,115075.39,,
2019-01-05,American Tavern,23.49,debit,Restaurants,Platinum Card,Expense,1,2019,2019-01,23.49,115098.88,150.0,15.659999999999998
2019-01-08,Gas Company,45.0,debit,Utilities,Checking,Expense,1,2019,2019-01,45.0,115143.88,150.0,30.0
2019-01-09,Credit Card Payment,491.45,credit,Credit Card Payment,Platinum Card,Income,1,2019,2019-01,491.45,115635.33,,
2019-01-09,Credit Card Payment,281.84,debit,Credit Card Payment,Checking,Expense,1,2019,2019-01,281.84,115917.17,,
2019-01-09,Spotify,10.69,debit,Music,Platinum Card,Expense,1,2019,2019-01,10.69,115927.86,11.0,97.18181818181819
2019-01-10,Barbershop,30.0,debit,Haircut,Silver Card,Expense,1,2019,2019-01,30.0,115957.86,30.0,100.0
2019-01-10,Phone Company,65.0,debit,Mobile Phone,Checking,Expense,1,2019,2019-01,65.0,116022.86,65.0,100.0
2019-01-10,Grocery Store,58.79,debit,Groceries,Silver Card,Expense,1,2019,2019-01,58.79,116081.65,150.0,39.19333333333333
2019-01-14,Shell,28.92,debit,Gas & Fuel,Silver Card,Expense,1,2019,2019-01,28.92,116110.56999999999,75.0,38.56
2019-01-15,Grocery Store,6.06,debit,Groceries,Silver Card,Expense,1,2019,2019-01,6.06,116116.62999999999,150.0,4.04
2019-01-16,City Water Charges,35.0,debit,Utilities,Checking,Expense,1,2019,2019-01,35.0,116151.62999999999,150.0,23.333333333333332
2019-01-16,Power Company,60.0,debit,Utilities,Checking,Expense,1,2019,2019-01,60.0,116211.62999999999,150.0,40.0
2019-01-18,State Farm,75.0,debit,Auto Insurance,Checking,Expense,1,2019,2019-01,75.0,116286.62999999999,75.0,100.0
2019-01-18,Biweekly Paycheck,2000.0,credit,Paycheck,Checking,Income,1,2019,2019-01,2000.0,118286.62999999999,,
2019-01-21,Credit Card Payment,277.99,credit,Credit Card Payment,Silver Card,Income,1,2019,2019-01,277.99,118564.62,,
2019-01-22,Credit Card Payment,277.99,debit,Credit Card Payment,Checking,Expense,1,2019,2019-01,277.99,118842.61,,
2019-01-24,Amazon,11.7,debit,Shopping,Platinum Card,Expense,1,2019,2019-01,11.7,118854.31,100.0,11.7
2019-01-24,Grocery Store,21.06,debit,Groceries,Silver Card,Expense,1,2019,2019-01,21.06,118875.37,150.0,14.04
2019-01-24,Amazon,4.21,debit,Shopping,Platinum Card,Expense,1,2019,2019-01,4.21,118879.58,100.0,4.21
2019-01-25,Internet Service Provider,75.0,debit,Internet,Checking,Expense,1,2019,2019-01,75.0,118954.58,75.0,100.0
2019-01-31,Credit Card Payment,1900.0,debit,Credit Card Payment,Checking,Expense,1,2019,2019-01,1900.0,120854.58,,
2019-01-31,Shell,31.32,debit,Gas & Fuel,Silver Card,Expense,1,2019,2019-01,31.32,120885.90000000001,75.0,41.760000000000005
2019-02-01,Biweekly Paycheck,2000.0,credit,Paycheck,Checking,Income,2,2019,2019-02,2000.0,122885.90000000001,,
2019-02-01,Roadside Diner,9.47,debit,Restaurants,Silver Card,Expense,2,2019,2019-02,9.47,122895.37000000001,150.0,6.3133333333333335
2019-02-01,Amazon,13.09,debit,Shopping,Platinum Card,Expense,2,2019,2019-02,13.09,122908.46,100.0,13.089999999999998
2019-02-04,Hardware Store,86.97,debit,Home Improvement,Silver Card,Expense,2,2019,2019-02,86.97,122995.43000000001,250.0,34.788000000000004
2019-02-04,Netflix,11.76,debit,Television,Platinum Card,Expense,2,2019,2019-02,11.76,123007.19,15.0,78.4
2019-02-05,Mortgage Payment,1100.0,debit,Mortgage & Rent,Checking,Expense,2,2019,2019-02,1100.0,124107.19,1100.0,100.0
2019-02-07,Gas Company,65.0,debit,Utilities,Checking,Expense,2,2019,2019-02,65.0,124172.19,150.0,43.333333333333336
2019-02-08,Starbucks,3.0,debit,Coffee Shops,Platinum Card,Expense,2,2019,2019-02,3.0,124175.19,15.0,20.0
2019-02-08,Thai Restaurant,27.47,debit,Restaurants,Platinum Card,Expense,2,2019,2019-02,27.47,124202.66,150.0,18.313333333333333
2019-02-09,Spotify,10.69,debit,Music,Platinum Card,Expense,2,2019,2019-02,10.69,124213.35,11.0,97.18181818181819
2019-02-11,Starbucks,3.0,debit,Coffee Shops,Platinum Card,Expense,2,2019,2019-02,3.0,124216.35,15.0,20.0
2019-02-11,Credit Card Payment,133.95,debit,Credit Card Payment,Checking,Expense,2,2019,2019-02,133.95,124350.3,,
2019-02-11,BP,24.01,debit,Gas & Fuel,Platinum Card,Expense,2,2019,2019-02,24.01,124374.31,75.0,32.013333333333335
2019-02-12,Grocery Store,30.54,debit,Groceries,Platinum Card,Expense,2,2019,2019-02,30.54,124404.84999999999,150.0,20.36
2019-02-12,Phone Company,65.0,debit,Mobile Phone,Checking,Expense,2,2019,2019-02,65.0,124469.84999999999,65.0,100.0
2019-02-13,Grocery Store,8.21,debit,Groceries,Platinum Card,Expense,2,2019,2019-02,8.21,124478.06,150.0,5.4733333333333345
2019-02-15,Credit Card Payment,207.47,credit,Credit Card Payment,Platinum Card,Income,2,2019,2019-02,207.47,124685.53,,
2019-02-15,Grocery Store,4.59,debit,Groceries,Platinum Card,Expense,2,2019,2019-02,4.59,124690.12,150.0,3.06
2019-02-15,Biweekly Paycheck,2000.0,credit,Paycheck,Checking,Income,2,2019,2019-02,2000.0,126690.12,,
2019-02-15,Power Company,60.0,debit,Utilities,Checking,Expense,2,2019,2019-02,60.0,126750.12,150.0,40.0
2019-02-16,Amazon,37.45,debit,Shopping,Platinum Card,Expense,2,2019,2019-02,37.45,126787.56999999999,100.0,37.45
2019-02-16,American Tavern,32.75,debit,Restaurants,Platinum Card,Expense,2,2019,2019-02,32.75,126820.31999999999,150.0,21.833333333333332
2019-02-16,Brewing Company,8.0,debit,Alcohol & Bars,Platinum Card,Expense,2,2019,2019-02,8.0,126828.31999999999,50.0,16.0
2019-02-19,Credit Card Payment,574.84,debit,Credit Card Payment,Checking,Expense,2,2019,2019-02,574.84,127403.15999999999,,
2019-02-19,City Water Charges,35.0,debit,Utilities,Checking,Expense,2,2019,2019-02,35.0,127438.15999999999,150.0,23.333333333333332
2019-02-20,State Farm,75.0,debit,Auto Insurance,Checking,Expense,2,2019,2019-02,75.0,127513.15999999999,75.0,100.0
2019-02-20,Credit Card Payment,292.54,credit,Credit Card Payment,Silver Card,Income,2,2019,2019-02,292.54,127805.69999999998,,
2019-02-20,Barbershop,30.0,debit,Haircut,Platinum Card,Expense,2,2019,2019-02,30.0,127835.69999999998,30.0,100.0
2019-02-21,Credit Card Payment,292.54,debit,Credit Card Payment,Checking,Expense,2,2019,2019-02,292.54,128128.23999999998,,
2019-02-21,Grocery Store,46.96,debit,Groceries,Silver Card,Expense,2,2019,2019-02,46.96,128175.19999999998,150.0,31.306666666666665
2019-02-25,BP,33.8,debit,Gas & Fuel,Silver Card,Expense,2,2019,2019-02,33.8,128208.99999999999,75.0,45.06666666666666
2019-02-25,Internet Service Provider,75.0,debit,Internet,Checking,Expense,2,2019,2019-02,75.0,128283.99999999999,75.0,100.0
2019-02-27,Roadside Diner,25.77,debit,Restaurants,Silver Card,Expense,2,2019,2019-02,25.77,128309.76999999999,150.0,17.18
2019-02-28,Grocery Store,32.07,debit,Groceries,Silver Card,Expense,2,2019,2019-02,32.07,128341.84,150.0,21.38
2019-03-01,Biweekly Paycheck,2000.0,credit,Paycheck,Checking,Income,3,2019,2019-03,2000.0,130341.84,,
2019-03-01,Amazon,13.09,debit,Shopping,Platinum Card,Expense,3,2019,2019-03,13.09,130354.93,100.0,13.089999999999998
2019-03-04,Grocery Store,92.04,debit,Groceries,Silver Card,Expense,3,2019,2019-03,92.04,130446.96999999999,150.0,61.36000000000001
2019-03-04,Mortgage Payment,1100.0,debit,Mortgage & Rent,Checking,Expense,3,2019,2019-03,1100.0,131546.96999999997,1100.0,100.0
2019-03-04,Netflix,11.76,debit,Television,Platinum Card,Expense,3,2019,2019-03,11.76,131558.72999999998,15.0,78.4
2019-03-05,Fancy Restaurant,7.0,debit,Restaurants,Silver Card,Expense,3,2019,2019-03,7.0,131565.72999999998,150.0,4.666666666666667
2019-03-06,Credit Card Payment,491.86,debit,Credit Card Payment,Checking,Expense,3,2019,2019-03,491.86,132057.58999999997,,
2019-03-08,BP,34.08,debit,Gas & Fuel,Platinum Card,Expense,3,2019,2019-03,34.08,132091.66999999995,75.0,45.44
2019-03-08,Amazon,27.17,debit,Shopping,Platinum Card,Expense,3,2019,2019-03,27.17,132118.83999999997,100.0,27.169999999999998
2019-03-08,Gas Company,49.0,debit,Utilities,Checking,Expense,3,2019,2019-03,49.0,132167.83999999997,150.0,32.666666666666664
2019-03-09,Spotify,10.69,debit,Music,Platinum Card,Expense,3,2019,2019-03,10.69,132178.52999999997,11.0,97.18181818181819
2019-03-12,Bakery Place,3.02,debit,Restaurants,Platinum Card,Expense,3,2019,2019-03,3.02,132181.54999999996,150.0,2.013333333333333
2019-03-12,Phone Company,65.0,debit,Mobile Phone,Checking,Expense,3,2019,2019-03,65.0,132246.54999999996,65.0,100.0
2019-03-13,Credit Card Payment,532.86,credit,Credit Card Payment,Platinum Card,Income,3,2019,2019-03,532.86,132779.40999999995,,
2019-03-13,Credit Card Payment,301.79,credit,Credit Card Payment,Silver Card,Income,3,2019,2019-03,301.79,133081.19999999995,,
2019-03-14,Credit Card Payment,305.27,debit,Credit Card Payment,Checking,Expense,3,2019,2019-03,305.27,133386.46999999994,,
2019-03-14,Credit Card Payment,301.79,debit,Credit Card Payment,Checking,Expense,3,2019,2019-03,301.79,133688.25999999995,,
2019-03-14,Brunch Restaurant,8.0,debit,Restaurants,Platinum Card,Expense,3,2019,2019-03,8.0,133696.25999999995,150.0,5.333333333333334
2019-03-15,Biweekly Paycheck,2000.0,credit,Paycheck,Checking,Income,3,2019,2019-03,2000.0,135696.25999999995,,
2019-03-15,Power Company,60.0,debit,Utilities,Checking,Expense,3,2019,2019-03,60.0,135756.25999999995,150.0,40.0
2019-03-18,Best Buy,320.99,debit,Electronics & Software,Platinum Card,Expense,3,2019,2019-03,320.99,136077.24999999994,0.0,
2019-03-18,Grocery Store,16.23,debit,Groceries,Platinum Card,Expense,3,2019,2019-03,16.23,136093.47999999995,150.0,10.82
2019-03-19,City Water Charges,35.0,debit,Utilities,Checking,Expense,3,2019,2019-03,35.0,136128.47999999995,150.0,23.333333333333332
2019-03-19,Amazon,13.84,debit,Shopping,Platinum Card,Expense,3,2019,2019-03,13.84,136142.31999999995,100.0,13.84
2019-03-20,State Farm,75.0,debit,Auto Insurance,Checking,Expense,3,2019,2019-03,75.0,136217.31999999995,75.0,100.0
2019-03-22,BP,37.51,debit,Gas & Fuel,Platinum Card,Expense,3,2019,2019-03,37.51,136254.82999999996,75.0,50.013333333333335
2019-03-23,Starbucks,5.2,debit,Coffee Shops,Platinum Card,Expense,3,2019,2019-03,5.2,136260.02999999997,15.0,34.66666666666667
2019-03-25,Internet Service Provider,75.0,debit,Internet,Checking,Expense,3,2019,2019-03,75.0,136335.02999999997,75.0,100.0
2019-03-26,Amazon,16.04,debit,Shopping,Platinum Card,Expense,3,2019,2019-03,16.04,136351.06999999998,100.0,16.04
2019-03-27,Brewing Company,49.63,debit,Alcohol & Bars,Platinum Card,Expense,3,2019,2019-03,49.63,136400.69999999998,50.0,99.26
2019-03-27,Grocery Store,4.46,debit,Groceries,Platinum Card,Expense,3,2019,2019-03,4.46,136405.15999999997,150.0,2.9733333333333336
2019-03-29,Biweekly Paycheck,2000.0,credit,Paycheck,Checking,Income,3,2019,2019-03,2000.0,138405.15999999997,,
2019-03-30,Starbucks,12.84,debit,Coffee Shops,Platinum Card,Expense,3,2019,2019-03,12.84,138417.99999999997,15.0,85.6
2019-03-31,Credit Card Payment,957.6,credit,Credit Card Payment,Platinum Card,Income,3,2019,2019-03,957.6,139375.59999999998,,
2019-04-01,Amazon,13.09,debit,Shopping,Platinum Card,Expense,4,2019,2019-04,13.09,139388.68999999997,100.0,13.089999999999998
2019-04-01,Credit Card Payment,600.51,credit,Credit Card Payment,Platinum Card,Income,4,2019,2019-04,600.51,139989.19999999998,,
2019-04-01,Credit Card Payment,1552.65,debit,Credit Card Payment,Checking,Expense,4,2019,2019-04,1552.65,141541.84999999998,,
2019-04-02,Mortgage Payment,1100.0,debit,Mortgage & Rent,Checking,Expense,4,2019,2019-04,1100.0,142641.84999999998,1100.0,100.0
2019-04-04,Grocery Store,5.64,debit,Groceries,Platinum Card,Expense,4,2019,2019-04,5.64,142647.49,150.0,3.7599999999999993
2019-04-04,Amazon,35.9,debit,Shopping,Platinum Card,Expense,4,2019,2019-04,35.9,142683.38999999998,100.0,35.9
2019-04-04,Netflix,11.76,debit,Television,Platinum Card,Expense,4,2019,2019-04,11.76,142695.15,15.0,78.4
2019-04-06,Amazon,27.54,debit,Shopping,Platinum Card,Expense,4,2019,2019-04,27.54,142722.69,100.0,27.54
2019-04-08,Gas Company,30.0,debit,Utilities,Checking,Expense,4,2019,2019-04,30.0,142752.69,150.0,20.0
2019-04-09,Credit Card Payment,436.75,debit,Credit Card Payment,Checking,Expense,4,2019,2019-04,436.75,143189.44,,
2019-04-09,Grocery Store,10.7,debit,Groceries,Platinum Card,Expense,4,2019,2019-04,10.7,143200.14,150.0,7.133333333333333
2019-04-09,Barbershop,30.0,debit,Haircut,Platinum Card,Expense,4,2019,2019-04,30.0,143230.14,30.0,100.0
2019-04-09,Spotify,10.69,debit,Music,Platinum Card,Expense,4,2019,2019-04,10.69,143240.83000000002,11.0,97.18181818181819
2019-04-10,Phone Company,65.0,debit,Mobile Phone,Checking,Expense,4,2019,2019-04,65.0,143305.83000000002,65.0,100.0
2019-04-12,Best Buy,44.93,debit,Electronics & Software,Silver Card,Expense,4,2019,2019-04,44.93,143350.76,0.0,
2019-04-12,Grocery Store,41.34,debit,Groceries,Platinum Card,Expense,4,2019,2019-04,41.34,143392.1,150.0,27.560000000000002
2019-04-12,Biweekly Paycheck,2000.0,credit,Paycheck,Checking,Income,4,2019,2019-04,2000.0,145392.1,,
2019-04-13,QuikTrip,38.94,debit,Gas & Fuel,Platinum Card,Expense,4,2019,2019-04,38.94,145431.04,75.0,51.92
2019-04-13,Grocery Store,16.87,debit,Groceries,Platinum Card,Expense,4,2019,2019-04,16.87,145447.91,150.0,11.246666666666668
2019-04-13,Vietnamese Restaurant,20.64,debit,Restaurants,Platinum Card,Expense,4,2019,2019-04,20.64,145468.55000000002,150.0,13.76
2019-04-15,Power Company,60.0,debit,Utilities,Checking,Expense,4,2019,2019-04,60.0,145528.55000000002,150.0,40.0
2019-04-16,City Water Charges,35.0,debit,Utilities,Checking,Expense,4,2019,2019-04,35.0,145563.55000000002,150.0,23.333333333333332
2019-04-18,State Farm,75.0,debit,Auto Insurance,Checking,Expense,4,2019,2019-04,75.0,145638.55000000002,75.0,100.0
2019-04-18,Credit Card Payment,604.32,credit,Credit Card Payment,Silver Card,Income,4,2019,2019-04,604.32,146242.87000000002,,
2019-04-18,Credit Card Payment,458.1,credit,Credit Card Payment,Platinum Card,Income,4,2019,2019-04,458.1,146700.97000000003,,
2019-04-19,Grocery Store,10.89,debit,Groceries,Platinum Card,Expense,4,2019,2019-04,10.89,146711.86000000004,150.0,7.26
2019-04-19,Credit Card Payment,604.32,debit,Credit Card Payment,Checking,Expense,4,2019,2019-04,604.32,147316.18000000005,,
2019-04-22,Greek Restaurant,64.52,debit,Restaurants,Silver Card,Expense,4,2019,2019-04,64.52,147380.70000000004,150.0,43.01333333333333
2019-04-22,Brewing Company,14.4,debit,Alcohol & Bars,Silver Card,Expense,4,2019,2019-04,14.4,147395.10000000003,50.0,28.800000000000004
2019-04-23,Hardware Store,29.56,debit,Home Improvement,Silver Card,Expense,4,2019,2019-04,29.56,147424.66000000003,250.0,11.824
2019-04-25,Internet Service Provider,75.0,debit,Internet,Checking,Expense,4,2019,2019-04,75.0,147499.66000000003,75.0,100.0
2019-04-26,Biweekly Paycheck,2000.0,credit,Paycheck,Checking,Income,4,2019,2019-04,2000.0,149499.66000000003,,
2019-04-27,Brewing Company,40.0,debit,Alcohol & Bars,Platinum Card,Expense,4,2019,2019-04,40.0,149539.66000000003,50.0,80.0
2019-04-27,Credit Card Payment,268.96,credit,Credit Card Payment,Silver Card,Income,4,2019,2019-04,268.96,149808.62000000002,,
2019-04-27,American Tavern,14.74,debit,Restaurants,Silver Card,Expense,4,2019,2019-04,14.74,149823.36000000002,150.0,9.826666666666666
2019-04-29,Credit Card Payment,268.96,debit,Credit Card Payment,Checking,Expense,4,2019,2019-04,268.96,150092.32,,
2019-04-29,Grocery Store,5.64,debit,Groceries,Platinum Card,Expense,4,2019,2019-04,5.64,150097.96000000002,150.0,3.7599999999999993
2019-04-30,BP,39.08,debit,Gas & Fuel,Platinum Card,Expense,4,2019,2019-04,39.08,150137.04,75.0,52.10666666666667
2019-05-01,Amazon,13.09,debit,Shopping,Platinum Card,Expense,5,2019,2019-05,13.09,150150.13,100.0,13.089999999999998
2019-05-02,Mortgage Payment,1100.0,debit,Mortgage & Rent,Checking,Expense,5,2019,2019-05,1100.0,151250.13,1100.0,100.0
2019-05-03,Credit Card Payment,758.07,debit,Credit Card Payment,Checking,Expense,5,2019,2019-05,758.07,152008.2,,
2019-05-04,Netflix,13.9,debit,Television,Platinum Card,Expense,5,2019,2019-05,13.9,152022.1,15.0,92.66666666666666
2019-05-06,Amazon,16.94,debit,Shopping,Platinum Card,Expense,5,2019,2019-05,16.94,152039.04,100.0,16.94
2019-05-07,Amazon,38.56,debit,Shopping,Platinum Card,Expense,5,2019,2019-05,38.56,152077.6,100.0,38.56
2019-05-09,Best Buy,331.69,debit,Electronics & Software,Platinum Card,Expense,5,2019,2019-05,331.69,152409.29,0.0,
2019-05-09,Spotify,10.69,debit,Music,Platinum Card,Expense,5,2019,2019-05,10.69,152419.98,11.0,97.18181818181819
2019-05-09,Target,3.2,debit,Shopping,Platinum Card,Expense,5,2019,2019-05,3.2,152423.18000000002,100.0,3.2
2019-05-09,Gas Company,30.0,debit,Utilities,Checking,Expense,5,2019,2019-05,30.0,152453.18000000002,150.0,20.0
2019-05-10,Best Buy,21.39,debit,Electronics & Software,Silver Card,Expense,5,2019,2019-05,21.39,152474.57000000004,0.0,
2019-05-10,Phone Company,65.0,debit,Mobile Phone,Checking,Expense,5,2019,2019-05,65.0,152539.57000000004,65.0,100.0
2019-05-10,Biweekly Paycheck,2000.0,credit,Paycheck,Checking,Income,5,2019,2019-05,2000.0,154539.57000000004,,
2019-05-13,Greek Restaurant,23.11,debit,Restaurants,Silver Card,Expense,5,2019,2019-05,23.11,154562.68000000002,150.0,15.406666666666666
2019-05-13,Fancy Restaurant,98.19,debit,Restaurants,Silver Card,Expense,5,2019,2019-05,98.19,154660.87000000002,150.0,65.46
2019-05-13,QuikTrip,35.24,debit,Gas & Fuel,Silver Card,Expense,5,2019,2019-05,35.24,154696.11000000002,75.0,46.98666666666667
2019-05-13,Credit Card Payment,480.88,debit,Credit Card Payment,Checking,Expense,5,2019,2019-05,480.88,155176.99000000002,,
2019-05-14,Grocery Store,2.02,debit,Groceries,Silver Card,Expense,5,2019,2019-05,2.02,155179.01,150.0,1.3466666666666667
2019-05-15,Power Company,60.0,debit,Utilities,Checking,Expense,5,2019,2019-05,60.0,155239.01,150.0,40.0
2019-05-17,Credit Card Payment,575.33,credit,Credit Card Payment,Platinum Card,Income,5,2019,2019-05,575.33,155814.34,,
2019-05-17,City Water Charges,35.0,debit,Utilities,Checking,Expense,5,2019,2019-05,35.0,155849.34,150.0,23.333333333333332
2019-05-20,State Farm,75.0,debit,Auto Insurance,Checking,Expense,5,2019,2019-05,75.0,155924.34,75.0,100.0
2019-05-20,Credit Card Payment,415.47,debit,Credit Card Payment,Checking,Expense,5,2019,2019-05,415.47,156339.81,,
2019-05-20,American Tavern,32.53,debit,Restaurants,Silver Card,Expense,5,2019,2019-05,32.53,156372.34,150.0,21.686666666666667
2019-05-24,Brunch Restaurant,8.0,debit,Restaurants,Platinum Card,Expense,5,2019,2019-05,8.0,156380.34,150.0,5.333333333333334
2019-05-24,Biweekly Paycheck,2000.0,credit,Paycheck,Checking,Income,5,2019,2019-05,2000.0,158380.34,,
2019-05-24,Credit Card Payment,765.68,credit,Credit Card Payment,Silver Card,Income,5,2019,2019-05,765.68,159146.02,,
2019-05-24,Hardware Store,27.96,debit,Home Improvement,Platinum Card,Expense,5,2019,2019-05,27.96,159173.97999999998,250.0,11.184000000000001
2019-05-25,QuikTrip,36.76,debit,Gas & Fuel,Platinum Card,Expense,5,2019,2019-05,36.76,159210.74,75.0,49.01333333333333
2019-05-25,Hardware Store,30.99,debit,Home Improvement,Platinum Card,Expense,5,2019,2019-05,30.99,159241.72999999998,250.0,12.395999999999999
2019-05-27,Mexican Restaurant,34.33,debit,Restaurants,Platinum Card,Expense,5,2019,2019-05,34.33,159276.05999999997,150.0,22.886666666666667
2019-05-28,Credit Card Payment,765.68,debit,Credit Card Payment,Checking,Expense,5,2019,2019-05,765.68,160041.73999999996,,
2019-05-30,Internet Service Provider,75.0,debit,Internet,Checking,Expense,5,2019,2019-05,75.0,160116.73999999996,75.0,100.0
2019-05-30,American Tavern,34.82,debit,Restaurants,Platinum Card,Expense,5,2019,2019-05,34.82,160151.55999999997,150.0,23.213333333333335
2019-06-01,Amazon,13.09,debit,Shopping,Platinum Card,Expense,6,2019,2019-06,13.09,160164.64999999997,100.0,13.089999999999998
2019-06-03,Credit Card Payment,260.95,credit,Credit Card Payment,Platinum Card,Income,6,2019,2019-06,260.95,160425.59999999998,,
2019-06-03,Starbucks,2.75,debit,Coffee Shops,Platinum Card,Expense,6,2019,2019-06,2.75,160428.34999999998,15.0,18.333333333333332
2019-06-03,Mortgage Payment,1100.0,debit,Mortgage & Rent,Checking,Expense,6,2019,2019-06,1100.0,161528.34999999998,1100.0,100.0
2019-06-04,Netflix,13.9,debit,Television,Platinum Card,Expense,6,2019,2019-06,13.9,161542.24999999997,15.0,92.66666666666666
2019-06-04,Barbershop,30.0,debit,Haircut,Platinum Card,Expense,6,2019,2019-06,30.0,161572.24999999997,30.0,100.0
2019-06-05,Grocery Store,23.0,debit,Groceries,Platinum Card,Expense,6,2019,2019-06,23.0,161595.24999999997,150.0,15.333333333333332
2019-06-05,Mexican Restaurant,23.24,debit,Restaurants,Platinum Card,Expense,6,2019,2019-06,23.24,161618.48999999996,150.0,15.49333333333333
2019-06-06,Starbucks,3.75,debit,Coffee Shops,Platinum Card,Expense,6,2019,2019-06,3.75,161622.23999999996,15.0,25.0
2019-06-06,Grocery Store,5.64,debit,Groceries,Platinum Card,Expense,6,2019,2019-06,5.64,161627.87999999998,150.0,3.7599999999999993
2019-06-07,Credit Card Payment,458.56,debit,Credit Card Payment,Checking,Expense,6,2019,2019-06,458.56,162086.43999999997,,
2019-06-07,Biweekly Paycheck,2000.0,credit,Paycheck,Checking,Income,6,2019,2019-06,2000.0,164086.43999999997,,
2019-06-07,Gas Company,30.0,debit,Utilities,Checking,Expense,6,2019,2019-06,30.0,164116.43999999997,150.0,20.0
2019-06-09,Spotify,10.69,debit,Music,Platinum Card,Expense,6,2019,2019-06,10.69,164127.12999999998,11.0,97.18181818181819
2019-06-12,Phone Company,65.0,debit,Mobile Phone,Checking,Expense,6,2019,2019-06,65.0,164192.12999999998,65.0,100.0
2019-06-13,Credit Card Payment,152.72,credit,Credit Card Payment,Platinum Card,Income,6,2019,2019-06,152.72,164344.84999999998,,
2019-06-14,Grocery Store,10.69,debit,Groceries,Silver Card,Expense,6,2019,2019-06,10.69,164355.53999999998,150.0,7.126666666666666
2019-06-15,BP,33.16,debit,Gas & Fuel,Silver Card,Expense,6,2019,2019-06,33.16,164388.69999999998,75.0,44.213333333333324
2019-06-17,City Water Charges,35.0,debit,Utilities,Checking,Expense,6,2019,2019-06,35.0,164423.69999999998,150.0,23.333333333333332
2019-06-17,Power Company,60.0,debit,Utilities,Checking,Expense,6,2019,2019-06,60.0,164483.69999999998,150.0,40.0
2019-06-18,Brewing Company,15.0,debit,Alcohol & Bars,Silver Card,Expense,6,2019,2019-06,15.0,164498.69999999998,50.0,30.0
2019-06-18,Shell,41.83,debit,Gas & Fuel,Silver Card,Expense,6,2019,2019-06,41.83,164540.52999999997,75.0,55.77333333333333
2019-06-19,State Farm,75.0,debit,Auto Insurance,Checking,Expense,6,2019,2019-06,75.0,164615.52999999997,75.0,100.0
2019-06-20,Credit Card Payment,375.26,debit,Credit Card Payment,Checking,Expense,6,2019,2019-06,375.26,164990.78999999998,,
2019-06-20,Mike's Construction Co.,9200.0,debit,Home Improvement,Checking,Expense,6,2019,2019-06,9200.0,174190.78999999998,250.0,3679.9999999999995
2019-06-20,Credit Card Payment,100.68,credit,Credit Card Payment,Silver Card,Income,6,2019,2019-06,100.68,174291.46999999997,,
2019-06-21,Credit Card Payment,100.68,debit,Credit Card Payment,Checking,Expense,6,2019,2019-06,100.68,174392.14999999997,,
2019-06-21,Biweekly Paycheck,2000.0,credit,Paycheck,Checking,Income,6,2019,2019-06,2000.0,176392.14999999997,,
2019-06-24,Brewing Company,15.0,debit,Alcohol & Bars,Silver Card,Expense,6,2019,2019-06,15.0,176407.14999999997,50.0,30.0
2019-06-28,BP,30.64,debit,Gas & Fuel,Silver Card,Expense,6,2019,2019-06,30.64,176437.78999999998,75.0,40.85333333333334
2019-06-30,Internet Service Provider,75.0,debit,Internet,Checking,Expense,6,2019,2019-06,75.0,176512.78999999998,75.0,100.0
2019-07-01,Starbucks,7.0,debit,Coffee Shops,Silver Card,Expense,7,2019,2019-07,7.0,176519.78999999998,15.0,46.666666666666664
2019-07-01,Grocery Store,99.47,debit,Groceries,Silver Card,Expense,7,2019,2019-07,99.47,176619.25999999998,150.0,66.31333333333333
2019-07-01,Hawaiian Grill,24.97,debit,Restaurants,Silver Card,Expense,7,2019,2019-07,24.97,176644.22999999998,150.0,16.646666666666665
2019-07-01,Thai Restaurant,24.0,debit,Restaurants,Silver Card,Expense,7,2019,2019-07,24.0,176668.22999999998,150.0,16.0
2019-07-01,Amazon,13.09,debit,Shopping,Platinum Card,Expense,7,2019,2019-07,13.09,176681.31999999998,100.0,13.089999999999998
2019-07-02,Hardware Store,229.9,debit,Home Improvement,Platinum Card,Expense,7,2019,2019-07,229.9,176911.21999999997,250.0,91.96
2019-07-02,Mortgage Payment,1100.0,debit,Mortgage & Rent,Checking,Expense,7,2019,2019-07,1100.0,178011.21999999997,1100.0,100.0
2019-07-04,Netflix,13.9,debit,Television,Platinum Card,Expense,7,2019,2019-07,13.9,178025.11999999997,15.0,92.66666666666666
2019-07-05,Biweekly Paycheck,2250.0,credit,Paycheck,Checking,Income,7,2019,2019-07,2250.0,180275.11999999997,,
2019-07-05,Brewing Company,19.0,debit,Alcohol & Bars,Silver Card,Expense,7,2019,2019-07,19.0,180294.11999999997,50.0,38.0
2019-07-06,Credit Card Payment,220.08,credit,Credit Card Payment,Silver Card,Income,7,2019,2019-07,220.08,180514.19999999995,,
2019-07-06,Grocery Store,92.98,debit,Groceries,Platinum Card,Expense,7,2019,2019-07,92.98,180607.17999999996,150.0,61.986666666666665
2019-07-06,Greek Restaurant,23.26,debit,Restaurants,Platinum Card,Expense,7,2019,2019-07,23.26,180630.43999999997,150.0,15.506666666666668
2019-07-07,Hardware Store,103.14,debit,Home Improvement,Platinum Card,Expense,7,2019,2019-07,103.14,180733.58,250.0,41.256
2019-07-08,Credit Card Payment,305.28,debit,Credit Card Payment,Checking,Expense,7,2019,2019-07,305.28,181038.86,,
2019-07-08,Credit Card Payment,220.08,debit,Credit Card Payment,Checking,Expense,7,2019,2019-07,220.08,181258.93999999997,,
2019-07-09,Credit Card Payment,549.72,credit,Credit Card Payment,Platinum Card,Income,7,2019,2019-07,549.72,181808.65999999997,,
2019-07-09,Spotify,10.69,debit,Music,Platinum Card,Expense,7,2019,2019-07,10.69,181819.34999999998,11.0,97.18181818181819
2019-07-10,Gas Company,30.0,debit,Utilities,Checking,Expense,7,2019,2019-07,30.0,181849.34999999998,150.0,20.0
2019-07-10,Phone Company,65.0,debit,Mobile Phone,Checking,Expense,7,2019,2019-07,65.0,181914.34999999998,65.0,100.0
2019-07-15,Grocery Store,87.14,debit,Groceries,Silver Card,Expense,7,2019,2019-07,87.14,182001.49,150.0,58.093333333333334
2019-07-16,Amazon,89.99,debit,Shopping,Platinum Card,Expense,7,2019,2019-07,89.99,182091.47999999998,100.0,89.99
2019-07-16,Power Company,60.0,debit,Utilities,Checking,Expense,7,2019,2019-07,60.0,182151.47999999998,150.0,40.0
2019-07-17,City Water Charges,35.0,debit,Utilities,Checking,Expense,7,2019,2019-07,35.0,182186.47999999998,150.0,23.333333333333332
2019-07-18,State Farm,75.0,debit,Auto Insurance,Checking,Expense,7,2019,2019-07,75.0,182261.47999999998,75.0,100.0
2019-07-18,Credit Card Payment,814.5,debit,Credit Card Payment,Checking,Expense,7,2019,2019-07,814.5,183075.97999999998,,
2019-07-18,BP,36.42,debit,Gas & Fuel,Silver Card,Expense,7,2019,2019-07,36.42,183112.4,75.0,48.56
2019-07-18,Grocery Store,29.83,debit,Groceries,Platinum Card,Expense,7,2019,2019-07,29.83,183142.22999999998,150.0,19.886666666666667
2019-07-18,Brunch Restaurant,8.82,debit,Restaurants,Platinum Card,Expense,7,2019,2019-07,8.82,183151.05,150.0,5.880000000000001
2019-07-19,Credit Card Payment,115.52,credit,Credit Card Payment,Platinum Card,Income,7,2019,2019-07,115.52,183266.56999999998,,
2019-07-19,Biweekly Paycheck,2250.0,credit,Paycheck,Checking,Income,7,2019,2019-07,2250.0,185516.56999999998,,
2019-07-19,Mexican Restaurant,28.0,debit,Restaurants,Platinum Card,Expense,7,2019,2019-07,28.0,185544.56999999998,150.0,18.666666666666668
2019-07-22,Credit Card Payment,257.08,credit,Credit Card Payment,Silver Card,Income,7,2019,2019-07,257.08,185801.64999999997,,
2019-07-22,Thai Restaurant,26.67,debit,Restaurants,Silver Card,Expense,7,2019,2019-07,26.67,185828.31999999998,150.0,17.78
2019-07-23,Credit Card Payment,257.08,debit,Credit Card Payment,Checking,Expense,7,2019,2019-07,257.08,186085.39999999997,,
2019-07-24,Starbucks,2.5,debit,Coffee Shops,Silver Card,Expense,7,2019,2019-07,2.5,186087.89999999997,15.0,16.666666666666664
2019-07-27,Barbershop,30.0,debit,Haircut,Silver Card,Expense,7,2019,2019-07,30.0,186117.89999999997,30.0,100.0
2019-07-28,Hardware Store,44.31,debit,Home Improvement,Platinum Card,Expense,7,2019,2019-07,44.31,186162.20999999996,250.0,17.724
2019-07-29,Grocery Store,5.35,debit,Groceries,Platinum Card,Expense,7,2019,2019-07,5.35,186167.55999999997,150.0,3.5666666666666664
2019-07-29,Fancy Restaurant,44.92,debit,Restaurants,Silver Card,Expense,7,2019,2019-07,44.92,186212.47999999998,150.0,29.946666666666665
2019-07-30,Grocery Store,15.77,debit,Groceries,Platinum Card,Expense,7,2019,2019-07,15.77,186228.24999999997,150.0,10.513333333333334
2019-07-30,Internet Service Provider,75.0,debit,Internet,Checking,Expense,7,2019,2019-07,75.0,186303.24999999997,75.0,100.0
2019-08-01,Amazon,13.09,debit,Shopping,Platinum Card,Expense,8,2019,2019-08,13.09,186316.33999999997,100.0,13.089999999999998
2019-08-02,Mortgage Payment,1100.0,debit,Mortgage & Rent,Checking,Expense,8,2019,2019-08,1100.0,187416.33999999997,1100.0,100.0
2019-08-02,Biweekly Paycheck,2250.0,credit,Paycheck,Checking,Income,8,2019,2019-08,2250.0,189666.33999999997,,
2019-08-03,Grocery Store,3.96,debit,Groceries,Platinum Card,Expense,8,2019,2019-08,3.96,189670.29999999996,150.0,2.64
2019-08-03,American Tavern,23.47,debit,Restaurants,Platinum Card,Expense,8,2019,2019-08,23.47,189693.76999999996,150.0,15.646666666666667
2019-08-03,BP,36.36,debit,Gas & Fuel,Platinum Card,Expense,8,2019,2019-08,36.36,189730.12999999995,75.0,48.480000000000004
2019-08-04,Netflix,13.9,debit,Television,Platinum Card,Expense,8,2019,2019-08,13.9,189744.02999999994,15.0,92.66666666666666
2019-08-05,Brewing Company,18.0,debit,Alcohol & Bars,Silver Card,Expense,8,2019,2019-08,18.0,189762.02999999994,50.0,36.0
2019-08-05,Credit Card Payment,349.28,credit,Credit Card Payment,Platinum Card,Income,8,2019,2019-08,349.28,190111.30999999994,,
2019-08-05,Credit Card Payment,117.65,credit,Credit Card Payment,Silver Card,Income,8,2019,2019-08,117.65,190228.95999999993,,
2019-08-06,Credit Card Payment,521.17,debit,Credit Card Payment,Checking,Expense,8,2019,2019-08,521.17,190750.12999999995,,
2019-08-06,Credit Card Payment,117.65,debit,Credit Card Payment,Checking,Expense,8,2019,2019-08,117.65,190867.77999999994,,
2019-08-06,Hardware Store,125.0,debit,Home Improvement,Checking,Expense,8,2019,2019-08,125.0,190992.77999999994,250.0,50.0
2019-08-08,Grocery Store,11.72,debit,Groceries,Silver Card,Expense,8,2019,2019-08,11.72,191004.49999999994,150.0,7.8133333333333335
2019-08-09,Spotify,10.69,debit,Music,Platinum Card,Expense,8,2019,2019-08,10.69,191015.18999999994,11.0,97.18181818181819
2019-08-09,Gas Company,30.0,debit,Utilities,Checking,Expense,8,2019,2019-08,30.0,191045.18999999994,150.0,20.0
2019-08-12,Thai Restaurant,26.67,debit,Restaurants,Silver Card,Expense,8,2019,2019-08,26.67,191071.85999999996,150.0,17.78
2019-08-12,Phone Company,65.0,debit,Mobile Phone,Checking,Expense,8,2019,2019-08,65.0,191136.85999999996,65.0,100.0
2019-08-14,Starbucks,2.75,debit,Coffee Shops,Platinum Card,Expense,8,2019,2019-08,2.75,191139.60999999996,15.0,18.333333333333332
2019-08-15,Credit Card Payment,335.2,debit,Credit Card Payment,Checking,Expense,8,2019,2019-08,335.2,191474.80999999997,,
2019-08-15,Power Company,60.0,debit,Utilities,Checking,Expense,8,2019,2019-08,60.0,191534.80999999997,150.0,40.0
2019-08-16,Biweekly Paycheck,2250.0,credit,Paycheck,Checking,Income,8,2019,2019-08,2250.0,193784.80999999997,,
2019-08-16,City Water Charges,35.0,debit,Utilities,Checking,Expense,8,2019,2019-08,35.0,193819.80999999997,150.0,23.333333333333332
2019-08-17,Credit Card Payment,87.17,credit,Credit Card Payment,Platinum Card,Income,8,2019,2019-08,87.17,193906.97999999998,,
2019-08-17,Grocery Store,33.15,debit,Groceries,Platinum Card,Expense,8,2019,2019-08,33.15,193940.12999999998,150.0,22.1
2019-08-17,Barbershop,19.0,debit,Haircut,Platinum Card,Expense,8,2019,2019-08,19.0,193959.12999999998,30.0,63.33333333333333
2019-08-17,American Tavern,3.5,debit,Restaurants,Platinum Card,Expense,8,2019,2019-08,3.5,193962.62999999998,150.0,2.3333333333333335
2019-08-19,Credit Card Payment,1248.95,debit,Credit Card Payment,Checking,Expense,8,2019,2019-08,1248.95,195211.58,,
2019-08-20,State Farm,75.0,debit,Auto Insurance,Checking,Expense,8,2019,2019-08,75.0,195286.58,75.0,100.0
2019-08-20,Starbucks,2.75,debit,Coffee Shops,Platinum Card,Expense,8,2019,2019-08,2.75,195289.33,15.0,18.333333333333332
2019-08-21,Shell,34.69,debit,Gas & Fuel,Platinum Card,Expense,8,2019,2019-08,34.69,195324.02,75.0,46.25333333333333
2019-08-23,Starbucks,2.75,debit,Coffee Shops,Platinum Card,Expense,8,2019,2019-08,2.75,195326.77,15.0,18.333333333333332
2019-08-25,Brunch Restaurant,39.43,debit,Restaurants,Platinum Card,Expense,8,2019,2019-08,39.43,195366.19999999998,150.0,26.286666666666665
2019-08-26,Hardware Store,66.75,debit,Home Improvement,Silver Card,Expense,8,2019,2019-08,66.75,195432.94999999998,250.0,26.700000000000003
2019-08-29,Starbucks,3.0,debit,Coffee Shops,Platinum Card,Expense,8,2019,2019-08,3.0,195435.94999999998,15.0,20.0
2019-08-30,Starbucks,2.75,debit,Coffee Shops,Platinum Card,Expense,8,2019,2019-08,2.75,195438.69999999998,15.0,18.333333333333332
2019-08-30,Internet Service Provider,75.0,debit,Internet,Checking,Expense,8,2019,2019-08,75.0,195513.69999999998,75.0,100.0
2019-08-30,Biweekly Paycheck,2250.0,credit,Paycheck,Checking,Income,8,2019,2019-08,2250.0,197763.69999999998,,
2019-08-31,Hardware Store,68.04,debit,Home Improvement,Platinum Card,Expense,8,2019,2019-08,68.04,197831.74,250.0,27.216
2019-08-31,BBQ Restaurant,41.78,debit,Restaurants,Silver Card,Expense,8,2019,2019-08,41.78,197873.52,150.0,27.853333333333335
2019-09-01,Amazon,13.09,debit,Shopping,Platinum Card,Expense,9,2019,2019-09,13.09,197886.61,100.0,13.089999999999998
2019-09-03,Fancy Restaurant,41.24,debit,Restaurants,Silver Card,Expense,9,2019,2019-09,41.24,197927.84999999998,150.0,27.493333333333336
2019-09-03,Mortgage Payment,1100.0,debit,Mortgage & Rent,Checking,Expense,9,2019,2019-09,1100.0,199027.84999999998,1100.0,100.0
2019-09-04,Netflix,13.9,debit,Television,Platinum Card,Expense,9,2019,2019-09,13.9,199041.74999999997,15.0,92.66666666666666
2019-09-05,Starbucks,3.75,debit,Coffee Shops,Platinum Card,Expense,9,2019,2019-09,3.75,199045.49999999997,15.0,25.0
2019-09-06,Credit Card Payment,1390.37,credit,Credit Card Payment,Platinum Card,Income,9,2019,2019-09,1390.37,200435.86999999997,,
2019-09-06,Credit Card Payment,502.75,debit,Credit Card Payment,Checking,Expense,9,2019,2019-09,502.75,200938.61999999997,,
2019-09-07,Brewing Company,12.87,debit,Alcohol & Bars,Platinum Card,Expense,9,2019,2019-09,12.87,200951.48999999996,50.0,25.739999999999995
2019-09-08,Brewing Company,19.3,debit,Alcohol & Bars,Platinum Card,Expense,9,2019,2019-09,19.3,200970.78999999995,50.0,38.6
2019-09-09,Gas Company,30.0,debit,Utilities,Checking,Expense,9,2019,2019-09,30.0,201000.78999999995,150.0,20.0
2019-09-09,Shell,28.77,debit,Gas & Fuel,Platinum Card,Expense,9,2019,2019-09,28.77,201029.55999999994,75.0,38.36
2019-09-09,Grocery Store,65.09,debit,Groceries,Silver Card,Expense,9,2019,2019-09,65.09,201094.64999999994,150.0,43.39333333333333
2019-09-09,Hardware Store,26.25,debit,Home Improvement,Silver Card,Expense,9,2019,2019-09,26.25,201120.89999999994,250.0,10.5
2019-09-09,Spotify,10.69,debit,Music,Platinum Card,Expense,9,2019,2019-09,10.69,201131.58999999994,11.0,97.18181818181819
2019-09-11,Phone Company,65.0,debit,Mobile Phone,Checking,Expense,9,2019,2019-09,65.0,201196.58999999994,65.0,100.0
2019-09-11,Credit Card Payment,360.56,credit,Credit Card Payment,Silver Card,Income,9,2019,2019-09,360.56,201557.14999999994,,
2019-09-12,Credit Card Payment,360.56,debit,Credit Card Payment,Checking,Expense,9,2019,2019-09,360.56,201917.70999999993,,
2019-09-13,Starbucks,2.75,debit,Coffee Shops,Platinum Card,Expense,9,2019,2019-09,2.75,201920.45999999993,15.0,18.333333333333332
2019-09-13,Biweekly Paycheck,2250.0,credit,Paycheck,Checking,Income,9,2019,2019-09,2250.0,204170.45999999993,,
2019-09-14,Grocery Store,46.44,debit,Groceries,Platinum Card,Expense,9,2019,2019-09,46.44,204216.89999999994,150.0,30.959999999999997
2019-09-15,Amazon,47.66,debit,Shopping,Platinum Card,Expense,9,2019,2019-09,47.66,204264.55999999994,100.0,47.66
2019-09-16,Credit Card Payment,90.57,debit,Credit Card Payment,Checking,Expense,9,2019,2019-09,90.57,204355.12999999995,,
2019-09-16,City Water Charges,35.0,debit,Utilities,Checking,Expense,9,2019,2019-09,35.0,204390.12999999995,150.0,23.333333333333332
2019-09-17,Credit Card Payment,186.13,credit,Credit Card Payment,Platinum Card,Income,9,2019,2019-09,186.13,204576.25999999995,,
2019-09-17,Power Company,60.0,debit,Utilities,Checking,Expense,9,2019,2019-09,60.0,204636.25999999995,150.0,40.0
2019-09-18,State Farm,75.0,debit,Auto Insurance,Checking,Expense,9,2019,2019-09,75.0,204711.25999999995,75.0,100.0
2019-09-18,Credit Card Payment,1606.46,debit,Credit Card Payment,Checking,Expense,9,2019,2019-09,1606.46,206317.71999999994,,
2019-09-19,Starbucks,2.75,debit,Coffee Shops,Platinum Card,Expense,9,2019,2019-09,2.75,206320.46999999994,15.0,18.333333333333332
2019-09-19,Brewing Company,40.81,debit,Alcohol & Bars,Platinum Card,Expense,9,2019,2019-09,40.81,206361.27999999994,50.0,81.62
2019-09-20,Credit Card Payment,9.43,credit,Credit Card Payment,Silver Card,Income,9,2019,2019-09,9.43,206370.70999999993,,
2019-09-22,Seafood Restaurant,131.1,debit,Restaurants,Platinum Card,Expense,9,2019,2019-09,131.1,206501.80999999994,150.0,87.4
2019-09-23,Credit Card Payment,9.43,debit,Credit Card Payment,Checking,Expense,9,2019,2019-09,9.43,206511.23999999993,,
2019-09-23,Grocery Store,27.71,debit,Groceries,Platinum Card,Expense,9,2019,2019-09,27.71,206538.94999999992,150.0,18.473333333333333
2019-09-23,Amazon,24.63,debit,Shopping,Platinum Card,Expense,9,2019,2019-09,24.63,206563.57999999993,100.0,24.63
2019-09-27,Biweekly Paycheck,2250.0,credit,Paycheck,Checking,Income,9,2019,2019-09,2250.0,208813.57999999993,,
2019-09-28,BP,33.46,debit,Gas & Fuel,Platinum Card,Expense,9,2019,2019-09,33.46,208847.03999999992,75.0,44.61333333333333
2019-09-28,Sheetz,4.27,debit,Gas & Fuel,Platinum Card,Expense,9,2019,2019-09,4.27,208851.3099999999,75.0,5.6933333333333325
2019-09-30,Starbucks,1.75,debit,Coffee Shops,Platinum Card,Expense,9,2019,2019-09,1.75,208853.0599999999,15.0,11.666666666666666
2019-09-30,Internet Service Provider,75.0,debit,Internet,Checking,Expense,9,2019,2019-09,75.0,208928.0599999999,75.0,100.0
